Date,Season,home,visitor,FT,hgoal,vgoal,division,tier,totgoal,goaldif,result,mngr,lfc_goals,at_anf
1893-09-02,1893,Middlesbrough Ironopolis,Liverpool,0-2,0,2,2,2,2,-2,A,"Barclay, Wil",2,Away
1893-09-09,1893,Liverpool,Lincoln City,4-0,4,0,2,2,4,4,H,"Barclay, Wil",4,Anfield
1893-09-16,1893,Manchester City,Liverpool,0-1,0,1,2,2,1,-1,A,"Barclay, Wil",1,Away
1893-09-23,1893,Liverpool,Birmingham City,3-1,3,1,2,2,4,2,H,"Barclay, Wil",3,Anfield
1893-09-30,1893,Notts County,Liverpool,1-1,1,1,2,2,2,0,D,"Barclay, Wil",1,Away
1893-10-07,1893,Liverpool,Middlesbrough Ironopolis,6-0,6,0,2,2,6,6,H,"Barclay, Wil",6,Anfield
1893-10-14,1893,Birmingham City,Liverpool,3-4,3,4,2,2,7,-1,A,"Barclay, Wil",4,Away
1893-10-21,1893,Burton Swifts,Liverpool,1-1,1,1,2,2,2,0,D,"Barclay, Wil",1,Away
1893-10-28,1893,Arsenal,Liverpool,0-5,0,5,2,2,5,-5,A,"Barclay, Wil",5,Away
1893-11-04,1893,Liverpool,Newcastle United,5-1,5,1,2,2,6,4,H,"Barclay, Wil",5,Anfield
1893-11-11,1893,Walsall,Liverpool,1-1,1,1,2,2,2,0,D,"Barclay, Wil",1,Away
1893-11-18,1893,Liverpool,Notts County,2-1,2,1,2,2,3,1,H,"Barclay, Wil",2,Anfield
1893-11-25,1893,Newcastle United,Liverpool,0-0,0,0,2,2,0,0,D,"Barclay, Wil",0,Away
1893-12-02,1893,Liverpool,Manchester City,3-0,3,0,2,2,3,3,H,"Barclay, Wil",3,Anfield
1893-12-09,1893,Liverpool,Walsall,3-0,3,0,2,2,3,3,H,"Barclay, Wil",3,Anfield
1893-12-28,1893,Crewe Alexandra,Liverpool,0-5,0,5,2,2,5,-5,A,"Barclay, Wil",5,Away
1893-12-30,1893,Liverpool,Grimsby Town,2-0,2,0,2,2,2,2,H,"Barclay, Wil",2,Anfield
1894-01-01,1893,Liverpool,Arsenal,2-0,2,0,2,2,2,2,H,"Barclay, Wil",2,Anfield
1894-01-06,1893,Rotherham Town,Liverpool,1-4,1,4,2,2,5,-3,A,"Barclay, Wil",4,Away
1894-01-13,1893,Liverpool,Rotherham Town,5-1,5,1,2,2,6,4,H,"Barclay, Wil",5,Anfield
1894-02-03,1893,Liverpool,Northwich Victoria,4-0,4,0,2,2,4,4,H,"Barclay, Wil",4,Anfield
1894-03-03,1893,Liverpool,Burton Swifts,3-1,3,1,2,2,4,2,H,"Barclay, Wil",3,Anfield
1894-03-17,1893,Lincoln City,Liverpool,1-1,1,1,2,2,2,0,D,"Barclay, Wil",1,Away
1894-03-24,1893,Liverpool,Crewe Alexandra,2-0,2,0,2,2,2,2,H,"Barclay, Wil",2,Anfield
1894-03-28,1893,Northwich Victoria,Liverpool,2-3,2,3,2,2,5,-1,A,"Barclay, Wil",3,Away
1894-03-31,1893,Grimsby Town,Liverpool,0-1,0,1,2,2,1,-1,A,"Barclay, Wil",1,Away
1894-04-07,1893,Port Vale,Liverpool,2-2,2,2,2,2,4,0,D,"Barclay, Wil",2,Away
1894-04-14,1893,Liverpool,Port Vale,2-1,2,1,2,2,3,1,H,"Barclay, Wil",2,Anfield
1894-09-01,1894,Blackburn Rovers,Liverpool,1-1,1,1,1,1,2,0,D,"Barclay, Wil",1,Away
1894-09-03,1894,Burnley,Liverpool,3-3,3,3,1,1,6,0,D,"Barclay, Wil",3,Away
1894-09-08,1894,Liverpool,Aston Villa,1-2,1,2,1,1,3,-1,A,"Barclay, Wil",1,Anfield
1894-09-13,1894,Liverpool,Bolton Wanderers,1-2,1,2,1,1,3,-1,A,"Barclay, Wil",1,Anfield
1894-09-15,1894,West Bromwich Albion,Liverpool,5-0,5,0,1,1,5,5,H,"Barclay, Wil",0,Away
1894-09-22,1894,Liverpool,Blackburn Rovers,2-2,2,2,1,1,4,0,D,"Barclay, Wil",2,Anfield
1894-09-29,1894,Wolverhampton Wanderers,Liverpool,3-1,3,1,1,1,4,2,H,"Barclay, Wil",1,Away
1894-10-06,1894,Liverpool,Sheffield United,2-2,2,2,1,1,4,0,D,"Barclay, Wil",2,Anfield
1894-10-13,1894,Everton,Liverpool,3-0,3,0,1,1,3,3,H,"Barclay, Wil",0,Away
1894-10-20,1894,Liverpool,Stoke City,2-0,2,0,1,1,2,2,H,"Barclay, Wil",2,Anfield
1894-10-27,1894,Aston Villa,Liverpool,5-0,5,0,1,1,5,5,H,"Barclay, Wil",0,Away
1894-11-03,1894,Liverpool,Burnley,0-3,0,3,1,1,3,-3,A,"Barclay, Wil",0,Anfield
1894-11-10,1894,Stoke City,Liverpool,3-1,3,1,1,1,4,2,H,"Barclay, Wil",1,Away
1894-11-17,1894,Liverpool,Everton,2-2,2,2,1,1,4,0,D,"Barclay, Wil",2,Anfield
1894-11-24,1894,Sunderland,Liverpool,3-2,3,2,1,1,5,1,H,"Barclay, Wil",2,Away
1894-12-01,1894,Liverpool,Wolverhampton Wanderers,3-3,3,3,1,1,6,0,D,"Barclay, Wil",3,Anfield
1894-12-08,1894,Sheffield United,Liverpool,2-2,2,2,1,1,4,0,D,"Barclay, Wil",2,Away
1894-12-15,1894,Liverpool,Birmingham City,3-1,3,1,1,1,4,2,H,"Barclay, Wil",3,Anfield
1894-12-25,1894,Bolton Wanderers,Liverpool,1-0,1,0,1,1,1,1,H,"Barclay, Wil",0,Away
1894-12-29,1894,Birmingham City,Liverpool,3-0,3,0,1,1,3,3,H,"Barclay, Wil",0,Away
1895-01-01,1894,Liverpool,West Bromwich Albion,4-0,4,0,1,1,4,4,H,"Barclay, Wil",4,Anfield
1895-01-05,1894,Sheffield Wednesday,Liverpool,5-0,5,0,1,1,5,5,H,"Barclay, Wil",0,Away
1895-01-09,1894,Derby County,Liverpool,0-1,0,1,1,1,1,-1,A,"Barclay, Wil",1,Away
1895-01-12,1894,Liverpool,Nottingham Forest,5-0,5,0,1,1,5,5,H,"Barclay, Wil",5,Anfield
1895-03-02,1894,Liverpool,Derby County,5-1,5,1,1,1,6,4,H,"Barclay, Wil",5,Anfield
1895-03-25,1894,Liverpool,Sunderland,2-3,2,3,1,1,5,-1,A,"Barclay, Wil",2,Anfield
1895-03-30,1894,Liverpool,Sheffield Wednesday,4-2,4,2,1,1,6,2,H,"Barclay, Wil",4,Anfield
1895-04-06,1894,Nottingham Forest,Liverpool,3-0,3,0,1,1,3,3,H,"Barclay, Wil",0,Away
1895-04-12,1894,Preston North End,Liverpool,2-2,2,2,1,1,4,0,D,"Barclay, Wil",2,Away
1895-04-20,1894,Liverpool,Preston North End,2-5,2,5,1,1,7,-3,A,"Barclay, Wil",2,Anfield
1895-09-07,1895,Notts County,Liverpool,2-3,2,3,2,2,5,-1,A,"Barclay, Wil",3,Away
1895-09-14,1895,Liverpool,Newcastle United,5-1,5,1,2,2,6,4,H,"Barclay, Wil",5,Anfield
1895-09-21,1895,Loughborough,Liverpool,2-4,2,4,2,2,6,-2,A,"Barclay, Wil",4,Away
1895-09-28,1895,Liverpool,Port Vale,5-1,5,1,2,2,6,4,H,"Barclay, Wil",5,Anfield
1895-09-30,1895,Liverpool,Burton Wanderers,4-1,4,1,2,2,5,3,H,"Barclay, Wil",4,Anfield
1895-10-05,1895,Newcastle United,Liverpool,1-0,1,0,2,2,1,1,H,"Barclay, Wil",0,Away
1895-10-07,1895,Liverpool,Crewe Alexandra,6-1,6,1,2,2,7,5,H,"Barclay, Wil",6,Anfield
1895-10-12,1895,Liverpool,Manchester United,7-1,7,1,2,2,8,6,H,"Barclay, Wil",7,Anfield
1895-10-19,1895,Grimsby Town,Liverpool,1-0,1,0,2,2,1,1,H,"Barclay, Wil",0,Away
1895-10-21,1895,Port Vale,Liverpool,5-4,5,4,2,2,9,1,H,"Barclay, Wil",4,Away
1895-10-26,1895,Liverpool,Notts County,3-0,3,0,2,2,3,3,H,"Barclay, Wil",3,Anfield
1895-11-02,1895,Manchester United,Liverpool,5-2,5,2,2,2,7,3,H,"Barclay, Wil",2,Away
1895-11-09,1895,Liverpool,Leicester City,3-1,3,1,2,2,4,2,H,"Barclay, Wil",3,Anfield
1895-11-16,1895,Arsenal,Liverpool,0-2,0,2,2,2,2,-2,A,"Barclay, Wil",2,Away
1895-11-23,1895,Liverpool,Darwen,0-0,0,0,2,2,0,0,D,"Barclay, Wil",0,Anfield
1895-11-30,1895,Leicester City,Liverpool,2-0,2,0,2,2,2,2,H,"Barclay, Wil",0,Away
1895-12-07,1895,Liverpool,Loughborough,1-0,1,0,2,2,1,1,H,"Barclay, Wil",1,Anfield
1895-12-14,1895,Darwen,Liverpool,0-4,0,4,2,2,4,-4,A,"Barclay, Wil",4,Away
1895-12-21,1895,Lincoln City,Liverpool,0-1,0,1,2,2,1,-1,A,"Barclay, Wil",1,Away
1896-01-01,1895,Liverpool,Manchester City,3-1,3,1,2,2,4,2,H,"Barclay, Wil",3,Anfield
1896-01-04,1895,Rotherham Town,Liverpool,0-5,0,5,2,2,5,-5,A,"Barclay, Wil",5,Away
1896-01-11,1895,Liverpool,Arsenal,3-0,3,0,2,2,3,3,H,"Barclay, Wil",3,Anfield
1896-01-25,1895,Liverpool,Lincoln City,6-1,6,1,2,2,7,5,H,"Barclay, Wil",6,Anfield
1896-02-18,1895,Liverpool,Rotherham Town,10-1,10,1,2,2,11,9,H,"Barclay, Wil",10,Anfield
1896-02-22,1895,Liverpool,Grimsby Town,3-1,3,1,2,2,4,2,H,"Barclay, Wil",3,Anfield
1896-02-29,1895,Burton Swifts,Liverpool,0-7,0,7,2,2,7,-7,A,"Barclay, Wil",7,Away
1896-03-07,1895,Burton Wanderers,Liverpool,2-1,2,1,2,2,3,1,H,"Barclay, Wil",1,Away
1896-03-21,1895,Liverpool,Burton Swifts,6-1,6,1,2,2,7,5,H,"Barclay, Wil",6,Anfield
1896-03-28,1895,Crewe Alexandra,Liverpool,0-7,0,7,2,2,7,-7,A,"Barclay, Wil",7,Away
1896-04-03,1895,Manchester City,Liverpool,1-1,1,1,2,2,2,0,D,"Barclay, Wil",1,Away
1896-09-01,1896,Sheffield Wednesday,Liverpool,1-2,1,2,1,1,3,-1,A,"Watson, Tom",2,Away
1896-09-05,1896,Blackburn Rovers,Liverpool,1-0,1,0,1,1,1,1,H,"Watson, Tom",0,Away
1896-09-07,1896,Liverpool,Bolton Wanderers,0-2,0,2,1,1,2,-2,A,"Watson, Tom",0,Anfield
1896-09-12,1896,Liverpool,Derby County,2-0,2,0,1,1,2,2,H,"Watson, Tom",2,Anfield
1896-09-19,1896,Bury,Liverpool,1-2,1,2,1,1,3,-1,A,"Watson, Tom",2,Away
1896-09-26,1896,Liverpool,West Bromwich Albion,0-0,0,0,1,1,0,0,D,"Watson, Tom",0,Anfield
1896-10-03,1896,Everton,Liverpool,2-1,2,1,1,1,3,1,H,"Watson, Tom",1,Away
1896-10-10,1896,Liverpool,Nottingham Forest,3-0,3,0,1,1,3,3,H,"Watson, Tom",3,Anfield
1896-10-17,1896,Sunderland,Liverpool,4-3,4,3,1,1,7,1,H,"Watson, Tom",3,Away
1896-10-19,1896,Sheffield United,Liverpool,1-1,1,1,1,1,2,0,D,"Watson, Tom",1,Away
1896-10-24,1896,Liverpool,Blackburn Rovers,4-0,4,0,1,1,4,4,H,"Watson, Tom",4,Anfield
1896-10-31,1896,West Bromwich Albion,Liverpool,0-1,0,1,1,1,1,-1,A,"Watson, Tom",1,Away
1896-11-07,1896,Liverpool,Sunderland,3-0,3,0,1,1,3,3,H,"Watson, Tom",3,Anfield
1896-11-14,1896,Preston North End,Liverpool,1-1,1,1,1,1,2,0,D,"Watson, Tom",1,Away
1896-11-21,1896,Liverpool,Everton,0-0,0,0,1,1,0,0,D,"Watson, Tom",0,Anfield
1896-11-28,1896,Nottingham Forest,Liverpool,2-0,2,0,1,1,2,2,H,"Watson, Tom",0,Away
1896-12-12,1896,Liverpool,Bury,3-1,3,1,1,1,4,2,H,"Watson, Tom",3,Anfield
1896-12-19,1896,Derby County,Liverpool,3-2,3,2,1,1,5,1,H,"Watson, Tom",2,Away
1896-12-25,1896,Liverpool,Aston Villa,3-3,3,3,1,1,6,0,D,"Watson, Tom",3,Anfield
1896-12-26,1896,Burnley,Liverpool,4-1,4,1,1,1,5,3,H,"Watson, Tom",1,Away
1897-01-01,1896,Bolton Wanderers,Liverpool,1-4,1,4,1,1,5,-3,A,"Watson, Tom",4,Away
1897-01-02,1896,Liverpool,Sheffield United,0-0,0,0,1,1,0,0,D,"Watson, Tom",0,Anfield
1897-01-09,1896,Wolverhampton Wanderers,Liverpool,1-2,1,2,1,1,3,-1,A,"Watson, Tom",2,Away
1897-01-16,1896,Liverpool,Stoke City,1-0,1,0,1,1,1,1,H,"Watson, Tom",1,Anfield
1897-02-06,1896,Stoke City,Liverpool,6-1,6,1,1,1,7,5,H,"Watson, Tom",1,Away
1897-03-04,1896,Liverpool,Wolverhampton Wanderers,3-0,3,0,1,1,3,3,H,"Watson, Tom",3,Anfield
1897-03-13,1896,Aston Villa,Liverpool,0-0,0,0,1,1,0,0,D,"Watson, Tom",0,Away
1897-03-27,1896,Liverpool,Burnley,1-2,1,2,1,1,3,-1,A,"Watson, Tom",1,Anfield
1897-04-03,1896,Liverpool,Sheffield Wednesday,2-2,2,2,1,1,4,0,D,"Watson, Tom",2,Anfield
1897-04-10,1896,Liverpool,Preston North End,0-0,0,0,1,1,0,0,D,"Watson, Tom",0,Anfield
1897-09-04,1897,Stoke City,Liverpool,2-2,2,2,1,1,4,0,D,"Watson, Tom",2,Away
1897-09-11,1897,Liverpool,Preston North End,0-0,0,0,1,1,0,0,D,"Watson, Tom",0,Anfield
1897-09-18,1897,Sheffield Wednesday,Liverpool,4-2,4,2,1,1,6,2,H,"Watson, Tom",2,Away
1897-09-25,1897,Liverpool,Everton,3-1,3,1,1,1,4,2,H,"Watson, Tom",3,Anfield
1897-10-02,1897,Preston North End,Liverpool,1-1,1,1,1,1,2,0,D,"Watson, Tom",1,Away
1897-10-09,1897,Liverpool,Stoke City,4-0,4,0,1,1,4,4,H,"Watson, Tom",4,Anfield
1897-10-16,1897,Everton,Liverpool,3-0,3,0,1,1,3,3,H,"Watson, Tom",0,Away
1897-10-23,1897,Liverpool,Derby County,4-2,4,2,1,1,6,2,H,"Watson, Tom",4,Anfield
1897-10-30,1897,Aston Villa,Liverpool,3-1,3,1,1,1,4,2,H,"Watson, Tom",1,Away
1897-11-06,1897,Liverpool,Nottingham Forest,1-2,1,2,1,1,3,-1,A,"Watson, Tom",1,Anfield
1897-11-13,1897,West Bromwich Albion,Liverpool,2-1,2,1,1,1,3,1,H,"Watson, Tom",1,Away
1897-11-20,1897,Liverpool,Wolverhampton Wanderers,1-0,1,0,1,1,1,1,H,"Watson, Tom",1,Anfield
1897-11-27,1897,Nottingham Forest,Liverpool,2-3,2,3,1,1,5,-1,A,"Watson, Tom",3,Away
1897-12-11,1897,Wolverhampton Wanderers,Liverpool,2-1,2,1,1,1,3,1,H,"Watson, Tom",1,Away
1897-12-18,1897,Liverpool,Blackburn Rovers,0-1,0,1,1,1,1,-1,A,"Watson, Tom",0,Anfield
1897-12-25,1897,Bolton Wanderers,Liverpool,0-2,0,2,1,1,2,-2,A,"Watson, Tom",2,Away
1897-12-27,1897,Liverpool,Sunderland,0-2,0,2,1,1,2,-2,A,"Watson, Tom",0,Anfield
1897-12-29,1897,Sheffield United,Liverpool,1-2,1,2,1,1,3,-1,A,"Watson, Tom",2,Away
1898-01-01,1897,Liverpool,West Bromwich Albion,1-1,1,1,1,1,2,0,D,"Watson, Tom",1,Anfield
1898-01-08,1897,Blackburn Rovers,Liverpool,2-1,2,1,1,1,3,1,H,"Watson, Tom",1,Away
1898-01-22,1897,Sunderland,Liverpool,1-0,1,0,1,1,1,1,H,"Watson, Tom",0,Away
1898-02-05,1897,Liverpool,Sheffield United,0-4,0,4,1,1,4,-4,A,"Watson, Tom",0,Anfield
1898-03-12,1897,Liverpool,Notts County,2-0,2,0,1,1,2,2,H,"Watson, Tom",2,Anfield
1898-03-19,1897,Liverpool,Bolton Wanderers,1-1,1,1,1,1,2,0,D,"Watson, Tom",1,Anfield
1898-03-26,1897,Bury,Liverpool,0-2,0,2,1,1,2,-2,A,"Watson, Tom",2,Away
1898-03-31,1897,Liverpool,Bury,2-2,2,2,1,1,4,0,D,"Watson, Tom",2,Anfield
1898-04-02,1897,Notts County,Liverpool,3-2,3,2,1,1,5,1,H,"Watson, Tom",2,Away
1898-04-11,1897,Liverpool,Sheffield Wednesday,4-0,4,0,1,1,4,4,H,"Watson, Tom",4,Anfield
1898-04-12,1897,Derby County,Liverpool,3-1,3,1,1,1,4,2,H,"Watson, Tom",1,Away
1898-04-16,1897,Liverpool,Aston Villa,4-0,4,0,1,1,4,4,H,"Watson, Tom",4,Anfield
1898-09-03,1898,Liverpool,Sheffield Wednesday,4-0,4,0,1,1,4,4,H,"Watson, Tom",4,Anfield
1898-09-10,1898,Sunderland,Liverpool,1-0,1,0,1,1,1,1,H,"Watson, Tom",0,Away
1898-09-17,1898,Liverpool,Wolverhampton Wanderers,1-0,1,0,1,1,1,1,H,"Watson, Tom",1,Anfield
1898-09-24,1898,Everton,Liverpool,1-2,1,2,1,1,3,-1,A,"Watson, Tom",2,Away
1898-10-01,1898,Liverpool,Notts County,0-0,0,0,1,1,0,0,D,"Watson, Tom",0,Anfield
1898-10-08,1898,Stoke City,Liverpool,2-1,2,1,1,1,3,1,H,"Watson, Tom",1,Away
1898-10-15,1898,Liverpool,Aston Villa,0-3,0,3,1,1,3,-3,A,"Watson, Tom",0,Anfield
1898-10-22,1898,Burnley,Liverpool,2-1,2,1,1,1,3,1,H,"Watson, Tom",1,Away
1898-10-29,1898,Liverpool,Sheffield United,2-1,2,1,1,1,3,1,H,"Watson, Tom",2,Anfield
1898-11-05,1898,Newcastle United,Liverpool,3-0,3,0,1,1,3,3,H,"Watson, Tom",0,Away
1898-11-12,1898,Liverpool,Preston North End,3-1,3,1,1,1,4,2,H,"Watson, Tom",3,Anfield
1898-11-19,1898,Bury,Liverpool,3-0,3,0,1,1,3,3,H,"Watson, Tom",0,Away
1898-11-26,1898,Nottingham Forest,Liverpool,0-3,0,3,1,1,3,-3,A,"Watson, Tom",3,Away
1898-12-03,1898,Liverpool,Bolton Wanderers,2-0,2,0,1,1,2,2,H,"Watson, Tom",2,Anfield
1898-12-10,1898,Derby County,Liverpool,1-0,1,0,1,1,1,1,H,"Watson, Tom",0,Away
1898-12-17,1898,Liverpool,West Bromwich Albion,2-2,2,2,1,1,4,0,D,"Watson, Tom",2,Anfield
1898-12-24,1898,Blackburn Rovers,Liverpool,1-3,1,3,1,1,4,-2,A,"Watson, Tom",3,Away
1898-12-26,1898,West Bromwich Albion,Liverpool,0-1,0,1,1,1,1,-1,A,"Watson, Tom",1,Away
1898-12-27,1898,Notts County,Liverpool,1-1,1,1,1,1,2,0,D,"Watson, Tom",1,Away
1898-12-31,1898,Sheffield Wednesday,Liverpool,0-3,0,3,1,1,3,-3,A,"Watson, Tom",3,Away
1899-01-02,1898,Sheffield United,Liverpool,0-2,0,2,1,1,2,-2,A,"Watson, Tom",2,Away
1899-01-07,1898,Liverpool,Sunderland,0-0,0,0,1,1,0,0,D,"Watson, Tom",0,Anfield
1899-01-14,1898,Wolverhampton Wanderers,Liverpool,0-0,0,0,1,1,0,0,D,"Watson, Tom",0,Away
1899-01-21,1898,Liverpool,Everton,2-0,2,0,1,1,2,2,H,"Watson, Tom",2,Anfield
1899-02-04,1898,Liverpool,Stoke City,1-0,1,0,1,1,1,1,H,"Watson, Tom",1,Anfield
1899-02-18,1898,Liverpool,Burnley,2-0,2,0,1,1,2,2,H,"Watson, Tom",2,Anfield
1899-03-11,1898,Preston North End,Liverpool,1-2,1,2,1,1,3,-1,A,"Watson, Tom",2,Away
1899-03-25,1898,Liverpool,Nottingham Forest,0-1,0,1,1,1,1,-1,A,"Watson, Tom",0,Anfield
1899-04-01,1898,Bolton Wanderers,Liverpool,2-1,2,1,1,1,3,1,H,"Watson, Tom",1,Away
1899-04-03,1898,Liverpool,Newcastle United,3-2,3,2,1,1,5,1,H,"Watson, Tom",3,Anfield
1899-04-08,1898,Liverpool,Derby County,4-0,4,0,1,1,4,4,H,"Watson, Tom",4,Anfield
1899-04-20,1898,Liverpool,Bury,1-0,1,0,1,1,1,1,H,"Watson, Tom",1,Anfield
1899-04-22,1898,Liverpool,Blackburn Rovers,2-0,2,0,1,1,2,2,H,"Watson, Tom",2,Anfield
1899-04-29,1898,Aston Villa,Liverpool,5-0,5,0,1,1,5,5,H,"Watson, Tom",0,Away
1899-09-02,1899,Stoke City,Liverpool,3-2,3,2,1,1,5,1,H,"Watson, Tom",2,Away
1899-09-09,1899,Liverpool,Sunderland,0-2,0,2,1,1,2,-2,A,"Watson, Tom",0,Anfield
1899-09-16,1899,West Bromwich Albion,Liverpool,2-0,2,0,1,1,2,2,H,"Watson, Tom",0,Away
1899-09-23,1899,Liverpool,Everton,1-2,1,2,1,1,3,-1,A,"Watson, Tom",1,Anfield
1899-09-30,1899,Blackburn Rovers,Liverpool,2-0,2,0,1,1,2,2,H,"Watson, Tom",0,Away
1899-10-05,1899,Notts County,Liverpool,2-1,2,1,1,1,3,1,H,"Watson, Tom",1,Away
1899-10-07,1899,Liverpool,Derby County,0-2,0,2,1,1,2,-2,A,"Watson, Tom",0,Anfield
1899-10-14,1899,Bury,Liverpool,2-1,2,1,1,1,3,1,H,"Watson, Tom",1,Away
1899-10-21,1899,Liverpool,Notts County,3-1,3,1,1,1,4,2,H,"Watson, Tom",3,Anfield
1899-10-28,1899,Manchester City,Liverpool,0-1,0,1,1,1,1,-1,A,"Watson, Tom",1,Away
1899-11-04,1899,Liverpool,Sheffield United,2-2,2,2,1,1,4,0,D,"Watson, Tom",2,Anfield
1899-11-11,1899,Newcastle United,Liverpool,1-1,1,1,1,1,2,0,D,"Watson, Tom",1,Away
1899-11-18,1899,Liverpool,Aston Villa,3-3,3,3,1,1,6,0,D,"Watson, Tom",3,Anfield
1899-11-25,1899,Liverpool,Wolverhampton Wanderers,1-1,1,1,1,1,2,0,D,"Watson, Tom",1,Anfield
1899-12-02,1899,Burnley,Liverpool,2-1,2,1,1,1,3,1,H,"Watson, Tom",1,Away
1899-12-09,1899,Liverpool,Preston North End,1-0,1,0,1,1,1,1,H,"Watson, Tom",1,Anfield
1899-12-16,1899,Nottingham Forest,Liverpool,1-0,1,0,1,1,1,1,H,"Watson, Tom",0,Away
1899-12-23,1899,Liverpool,Glossop North End,5-2,5,2,1,1,7,3,H,"Watson, Tom",5,Anfield
1899-12-25,1899,Derby County,Liverpool,3-2,3,2,1,1,5,1,H,"Watson, Tom",2,Away
1899-12-29,1899,Liverpool,Stoke City,0-0,0,0,1,1,0,0,D,"Watson, Tom",0,Anfield
1900-01-06,1899,Sunderland,Liverpool,1-0,1,0,1,1,1,1,H,"Watson, Tom",0,Away
1900-01-13,1899,Liverpool,West Bromwich Albion,2-0,2,0,1,1,2,2,H,"Watson, Tom",2,Anfield
1900-01-20,1899,Everton,Liverpool,3-1,3,1,1,1,4,2,H,"Watson, Tom",1,Away
1900-02-03,1899,Liverpool,Blackburn Rovers,3-1,3,1,1,1,4,2,H,"Watson, Tom",3,Anfield
1900-03-03,1899,Liverpool,Manchester City,5-2,5,2,1,1,7,3,H,"Watson, Tom",5,Anfield
1900-03-10,1899,Sheffield United,Liverpool,1-2,1,2,1,1,3,-1,A,"Watson, Tom",2,Away
1900-03-17,1899,Liverpool,Newcastle United,2-0,2,0,1,1,2,2,H,"Watson, Tom",2,Anfield
1900-03-24,1899,Aston Villa,Liverpool,1-0,1,0,1,1,1,1,H,"Watson, Tom",0,Away
1900-03-31,1899,Wolverhampton Wanderers,Liverpool,0-1,0,1,1,1,1,-1,A,"Watson, Tom",1,Away
1900-04-07,1899,Liverpool,Burnley,0-1,0,1,1,1,1,-1,A,"Watson, Tom",0,Anfield
1900-04-09,1899,Liverpool,Bury,2-0,2,0,1,1,2,2,H,"Watson, Tom",2,Anfield
1900-04-14,1899,Preston North End,Liverpool,1-3,1,3,1,1,4,-2,A,"Watson, Tom",3,Away
1900-04-21,1899,Liverpool,Nottingham Forest,1-0,1,0,1,1,1,1,H,"Watson, Tom",1,Anfield
1900-04-28,1899,Glossop North End,Liverpool,1-2,1,2,1,1,3,-1,A,"Watson, Tom",2,Away
1900-09-01,1900,Liverpool,Blackburn Rovers,3-0,3,0,1,1,3,3,H,"Watson, Tom",3,Anfield
1900-09-08,1900,Stoke City,Liverpool,1-2,1,2,1,1,3,-1,A,"Watson, Tom",2,Away
1900-09-15,1900,Liverpool,West Bromwich Albion,5-0,5,0,1,1,5,5,H,"Watson, Tom",5,Anfield
1900-09-22,1900,Everton,Liverpool,1-1,1,1,1,1,2,0,D,"Watson, Tom",1,Away
1900-09-29,1900,Liverpool,Sunderland,1-2,1,2,1,1,3,-1,A,"Watson, Tom",1,Anfield
1900-10-06,1900,Derby County,Liverpool,2-3,2,3,1,1,5,-1,A,"Watson, Tom",3,Away
1900-10-13,1900,Liverpool,Bolton Wanderers,2-1,2,1,1,1,3,1,H,"Watson, Tom",2,Anfield
1900-10-20,1900,Notts County,Liverpool,3-0,3,0,1,1,3,3,H,"Watson, Tom",0,Away
1900-10-27,1900,Liverpool,Preston North End,3-2,3,2,1,1,5,1,H,"Watson, Tom",3,Anfield
1900-11-03,1900,Wolverhampton Wanderers,Liverpool,2-1,2,1,1,1,3,1,H,"Watson, Tom",1,Away
1900-11-10,1900,Liverpool,Aston Villa,5-1,5,1,1,1,6,4,H,"Watson, Tom",5,Anfield
1900-11-17,1900,Sheffield Wednesday,Liverpool,3-2,3,2,1,1,5,1,H,"Watson, Tom",2,Away
1900-11-24,1900,Newcastle United,Liverpool,1-1,1,1,1,1,2,0,D,"Watson, Tom",1,Away
1900-12-01,1900,Liverpool,Sheffield United,1-2,1,2,1,1,3,-1,A,"Watson, Tom",1,Anfield
1900-12-08,1900,Manchester City,Liverpool,3-4,3,4,1,1,7,-1,A,"Watson, Tom",4,Away
1900-12-15,1900,Liverpool,Bury,1-0,1,0,1,1,1,1,H,"Watson, Tom",1,Anfield
1900-12-22,1900,Nottingham Forest,Liverpool,0-0,0,0,1,1,0,0,D,"Watson, Tom",0,Away
1900-12-25,1900,Liverpool,Derby County,0-0,0,0,1,1,0,0,D,"Watson, Tom",0,Anfield
1900-12-29,1900,Blackburn Rovers,Liverpool,3-1,3,1,1,1,4,2,H,"Watson, Tom",1,Away
1901-01-01,1900,Liverpool,Stoke City,3-1,3,1,1,1,4,2,H,"Watson, Tom",3,Anfield
1901-01-19,1900,Liverpool,Everton,1-2,1,2,1,1,3,-1,A,"Watson, Tom",1,Anfield
1901-02-16,1900,Bolton Wanderers,Liverpool,1-0,1,0,1,1,1,1,H,"Watson, Tom",0,Away
1901-02-23,1900,Sunderland,Liverpool,0-1,0,1,1,1,1,-1,A,"Watson, Tom",1,Away
1901-03-02,1900,Preston North End,Liverpool,2-2,2,2,1,1,4,0,D,"Watson, Tom",2,Away
1901-03-09,1900,Liverpool,Wolverhampton Wanderers,1-0,1,0,1,1,1,1,H,"Watson, Tom",1,Anfield
1901-03-16,1900,Aston Villa,Liverpool,0-2,0,2,1,1,2,-2,A,"Watson, Tom",2,Away
1901-03-23,1900,Liverpool,Sheffield Wednesday,1-1,1,1,1,1,2,0,D,"Watson, Tom",1,Anfield
1901-03-30,1900,Liverpool,Newcastle United,3-0,3,0,1,1,3,3,H,"Watson, Tom",3,Anfield
1901-04-08,1900,Liverpool,Notts County,1-0,1,0,1,1,1,1,H,"Watson, Tom",1,Anfield
1901-04-13,1900,Liverpool,Manchester City,3-1,3,1,1,1,4,2,H,"Watson, Tom",3,Anfield
1901-04-20,1900,Bury,Liverpool,0-0,0,0,1,1,0,0,D,"Watson, Tom",0,Away
1901-04-22,1900,Sheffield United,Liverpool,0-2,0,2,1,1,2,-2,A,"Watson, Tom",2,Away
1901-04-27,1900,Liverpool,Nottingham Forest,2-0,2,0,1,1,2,2,H,"Watson, Tom",2,Anfield
1901-04-29,1900,West Bromwich Albion,Liverpool,0-1,0,1,1,1,1,-1,A,"Watson, Tom",1,Away
1901-09-02,1901,Birmingham City,Liverpool,0-0,0,0,1,1,0,0,D,"Watson, Tom",0,Away
1901-09-07,1901,Stoke City,Liverpool,1-0,1,0,1,1,1,1,H,"Watson, Tom",0,Away
1901-09-14,1901,Liverpool,Everton,2-2,2,2,1,1,4,0,D,"Watson, Tom",2,Anfield
1901-09-21,1901,Sunderland,Liverpool,1-1,1,1,1,1,2,0,D,"Watson, Tom",1,Away
1901-09-28,1901,Liverpool,Birmingham City,3-1,3,1,1,1,4,2,H,"Watson, Tom",3,Anfield
1901-10-05,1901,Derby County,Liverpool,1-1,1,1,1,1,2,0,D,"Watson, Tom",1,Away
1901-10-12,1901,Liverpool,Sheffield Wednesday,1-2,1,2,1,1,3,-1,A,"Watson, Tom",1,Anfield
1901-10-19,1901,Notts County,Liverpool,2-2,2,2,1,1,4,0,D,"Watson, Tom",2,Away
1901-10-26,1901,Liverpool,Bolton Wanderers,1-1,1,1,1,1,2,0,D,"Watson, Tom",1,Anfield
1901-11-02,1901,Manchester City,Liverpool,2-3,2,3,1,1,5,-1,A,"Watson, Tom",3,Away
1901-11-09,1901,Liverpool,Wolverhampton Wanderers,4-1,4,1,1,1,5,3,H,"Watson, Tom",4,Anfield
1901-11-23,1901,Newcastle United,Liverpool,1-0,1,0,1,1,1,1,H,"Watson, Tom",0,Away
1901-11-30,1901,Liverpool,Aston Villa,1-0,1,0,1,1,1,1,H,"Watson, Tom",1,Anfield
1901-12-07,1901,Sheffield United,Liverpool,2-1,2,1,1,1,3,1,H,"Watson, Tom",1,Away
1901-12-14,1901,Liverpool,Nottingham Forest,0-2,0,2,1,1,2,-2,A,"Watson, Tom",0,Anfield
1901-12-26,1901,Liverpool,Sunderland,0-1,0,1,1,1,1,-1,A,"Watson, Tom",0,Anfield
1901-12-28,1901,Liverpool,Blackburn Rovers,1-0,1,0,1,1,1,1,H,"Watson, Tom",1,Anfield
1902-01-04,1901,Liverpool,Stoke City,7-0,7,0,1,1,7,7,H,"Watson, Tom",7,Anfield
1902-01-11,1901,Everton,Liverpool,4-0,4,0,1,1,4,4,H,"Watson, Tom",0,Away
1902-02-01,1901,Bury,Liverpool,0-0,0,0,1,1,0,0,D,"Watson, Tom",0,Away
1902-02-15,1901,Liverpool,Notts County,0-1,0,1,1,1,1,-1,A,"Watson, Tom",0,Anfield
1902-02-22,1901,Bolton Wanderers,Liverpool,1-0,1,0,1,1,1,1,H,"Watson, Tom",0,Away
1902-03-01,1901,Liverpool,Manchester City,4-0,4,0,1,1,4,4,H,"Watson, Tom",4,Anfield
1902-03-08,1901,Wolverhampton Wanderers,Liverpool,3-1,3,1,1,1,4,2,H,"Watson, Tom",1,Away
1902-03-15,1901,Grimsby Town,Liverpool,1-1,1,1,1,1,2,0,D,"Watson, Tom",1,Away
1902-03-22,1901,Liverpool,Newcastle United,0-1,0,1,1,1,1,-1,A,"Watson, Tom",0,Anfield
1902-03-29,1901,Aston Villa,Liverpool,0-1,0,1,1,1,1,-1,A,"Watson, Tom",1,Away
1902-04-01,1901,Sheffield Wednesday,Liverpool,1-1,1,1,1,1,2,0,D,"Watson, Tom",1,Away
1902-04-05,1901,Liverpool,Sheffield United,1-0,1,0,1,1,1,1,H,"Watson, Tom",1,Anfield
1902-04-12,1901,Nottingham Forest,Liverpool,1-1,1,1,1,1,2,0,D,"Watson, Tom",1,Away
1902-04-14,1901,Liverpool,Derby County,0-2,0,2,1,1,2,-2,A,"Watson, Tom",0,Anfield
1902-04-19,1901,Liverpool,Bury,1-0,1,0,1,1,1,1,H,"Watson, Tom",1,Anfield
1902-04-21,1901,Liverpool,Grimsby Town,2-2,2,2,1,1,4,0,D,"Watson, Tom",2,Anfield
1902-04-26,1901,Blackburn Rovers,Liverpool,1-1,1,1,1,1,2,0,D,"Watson, Tom",1,Away
1902-09-06,1902,Liverpool,Blackburn Rovers,5-2,5,2,1,1,7,3,H,"Watson, Tom",5,Anfield
1902-09-13,1902,Sunderland,Liverpool,2-1,2,1,1,1,3,1,H,"Watson, Tom",1,Away
1902-09-20,1902,Liverpool,Stoke City,1-1,1,1,1,1,2,0,D,"Watson, Tom",1,Anfield
1902-09-27,1902,Everton,Liverpool,3-1,3,1,1,1,4,2,H,"Watson, Tom",1,Away
1902-10-04,1902,Liverpool,Sheffield Wednesday,4-2,4,2,1,1,6,2,H,"Watson, Tom",4,Anfield
1902-10-11,1902,West Bromwich Albion,Liverpool,1-2,1,2,1,1,3,-1,A,"Watson, Tom",2,Away
1902-10-18,1902,Liverpool,Notts County,0-2,0,2,1,1,2,-2,A,"Watson, Tom",0,Anfield
1902-10-25,1902,Bolton Wanderers,Liverpool,1-1,1,1,1,1,2,0,D,"Watson, Tom",1,Away
1902-11-01,1902,Liverpool,Middlesbrough,5-0,5,0,1,1,5,5,H,"Watson, Tom",5,Anfield
1902-11-08,1902,Newcastle United,Liverpool,1-2,1,2,1,1,3,-1,A,"Watson, Tom",2,Away
1902-11-15,1902,Liverpool,Wolverhampton Wanderers,4-1,4,1,1,1,5,3,H,"Watson, Tom",4,Anfield
1902-11-22,1902,Derby County,Liverpool,2-1,2,1,1,1,3,1,H,"Watson, Tom",1,Away
1902-11-29,1902,Sheffield United,Liverpool,2-0,2,0,1,1,2,2,H,"Watson, Tom",0,Away
1902-12-06,1902,Liverpool,Grimsby Town,9-2,9,2,1,1,11,7,H,"Watson, Tom",9,Anfield
1902-12-13,1902,Aston Villa,Liverpool,1-2,1,2,1,1,3,-1,A,"Watson, Tom",2,Away
1902-12-20,1902,Liverpool,Nottingham Forest,2-1,2,1,1,1,3,1,H,"Watson, Tom",2,Anfield
1902-12-25,1902,Liverpool,Bolton Wanderers,5-1,5,1,1,1,6,4,H,"Watson, Tom",5,Anfield
1902-12-27,1902,Bury,Liverpool,3-1,3,1,1,1,4,2,H,"Watson, Tom",1,Away
1903-01-01,1902,Liverpool,West Bromwich Albion,0-2,0,2,1,1,2,-2,A,"Watson, Tom",0,Anfield
1903-01-03,1902,Blackburn Rovers,Liverpool,3-1,3,1,1,1,4,2,H,"Watson, Tom",1,Away
1903-01-17,1902,Stoke City,Liverpool,1-0,1,0,1,1,1,1,H,"Watson, Tom",0,Away
1903-01-31,1902,Sheffield Wednesday,Liverpool,3-1,3,1,1,1,4,2,H,"Watson, Tom",1,Away
1903-02-14,1902,Notts County,Liverpool,1-2,1,2,1,1,3,-1,A,"Watson, Tom",2,Away
1903-02-28,1902,Middlesbrough,Liverpool,0-2,0,2,1,1,2,-2,A,"Watson, Tom",2,Away
1903-03-07,1902,Liverpool,Newcastle United,3-0,3,0,1,1,3,3,H,"Watson, Tom",3,Anfield
1903-03-23,1902,Liverpool,Derby County,3-1,3,1,1,1,4,2,H,"Watson, Tom",3,Anfield
1903-03-28,1902,Liverpool,Sheffield United,2-4,2,4,1,1,6,-2,A,"Watson, Tom",2,Anfield
1903-03-30,1902,Liverpool,Sunderland,1-1,1,1,1,1,2,0,D,"Watson, Tom",1,Anfield
1903-04-04,1902,Grimsby Town,Liverpool,3-1,3,1,1,1,4,2,H,"Watson, Tom",1,Away
1903-04-10,1902,Liverpool,Everton,0-0,0,0,1,1,0,0,D,"Watson, Tom",0,Anfield
1903-04-11,1902,Liverpool,Aston Villa,2-1,2,1,1,1,3,1,H,"Watson, Tom",2,Anfield
1903-04-18,1902,Nottingham Forest,Liverpool,1-0,1,0,1,1,1,1,H,"Watson, Tom",0,Away
1903-04-25,1902,Liverpool,Bury,2-0,2,0,1,1,2,2,H,"Watson, Tom",2,Anfield
1903-04-27,1902,Wolverhampton Wanderers,Liverpool,0-2,0,2,1,1,2,-2,A,"Watson, Tom",2,Away
1903-09-05,1903,Nottingham Forest,Liverpool,2-1,2,1,1,1,3,1,H,"Watson, Tom",1,Away
1903-09-12,1903,Liverpool,Sheffield Wednesday,1-3,1,3,1,1,4,-2,A,"Watson, Tom",1,Anfield
1903-09-19,1903,Sunderland,Liverpool,2-1,2,1,1,1,3,1,H,"Watson, Tom",1,Away
1903-09-26,1903,Liverpool,West Bromwich Albion,1-3,1,3,1,1,4,-2,A,"Watson, Tom",1,Anfield
1903-10-01,1903,Notts County,Liverpool,4-2,4,2,1,1,6,2,H,"Watson, Tom",2,Away
1903-10-03,1903,Birmingham City,Liverpool,1-2,1,2,1,1,3,-1,A,"Watson, Tom",2,Away
1903-10-10,1903,Liverpool,Everton,2-2,2,2,1,1,4,0,D,"Watson, Tom",2,Anfield
1903-10-17,1903,Stoke City,Liverpool,5-2,5,2,1,1,7,3,H,"Watson, Tom",2,Away
1903-10-24,1903,Liverpool,Derby County,3-1,3,1,1,1,4,2,H,"Watson, Tom",3,Anfield
1903-10-31,1903,Manchester City,Liverpool,3-2,3,2,1,1,5,1,H,"Watson, Tom",2,Away
1903-11-07,1903,Liverpool,Notts County,2-1,2,1,1,1,3,1,H,"Watson, Tom",2,Anfield
1903-11-14,1903,Sheffield United,Liverpool,2-1,2,1,1,1,3,1,H,"Watson, Tom",1,Away
1903-11-21,1903,Liverpool,Newcastle United,1-0,1,0,1,1,1,1,H,"Watson, Tom",1,Anfield
1903-11-28,1903,Aston Villa,Liverpool,2-1,2,1,1,1,3,1,H,"Watson, Tom",1,Away
1903-12-12,1903,Liverpool,Wolverhampton Wanderers,1-2,1,2,1,1,3,-1,A,"Watson, Tom",1,Anfield
1903-12-19,1903,Bury,Liverpool,2-2,2,2,1,1,4,0,D,"Watson, Tom",2,Away
1903-12-25,1903,Derby County,Liverpool,2-0,2,0,1,1,2,2,H,"Watson, Tom",0,Away
1903-12-26,1903,Liverpool,Blackburn Rovers,1-2,1,2,1,1,3,-1,A,"Watson, Tom",1,Anfield
1903-12-28,1903,Wolverhampton Wanderers,Liverpool,4-2,4,2,1,1,6,2,H,"Watson, Tom",2,Away
1904-01-02,1903,Liverpool,Nottingham Forest,0-0,0,0,1,1,0,0,D,"Watson, Tom",0,Anfield
1904-01-09,1903,Sheffield Wednesday,Liverpool,2-1,2,1,1,1,3,1,H,"Watson, Tom",1,Away
1904-01-16,1903,Liverpool,Sunderland,2-1,2,1,1,1,3,1,H,"Watson, Tom",2,Anfield
1904-01-23,1903,West Bromwich Albion,Liverpool,2-2,2,2,1,1,4,0,D,"Watson, Tom",2,Away
1904-01-30,1903,Liverpool,Birmingham City,0-2,0,2,1,1,2,-2,A,"Watson, Tom",0,Anfield
1904-02-13,1903,Liverpool,Stoke City,0-0,0,0,1,1,0,0,D,"Watson, Tom",0,Anfield
1904-02-22,1903,Liverpool,Middlesbrough,1-0,1,0,1,1,1,1,H,"Watson, Tom",1,Anfield
1904-02-27,1903,Liverpool,Manchester City,2-2,2,2,1,1,4,0,D,"Watson, Tom",2,Anfield
1904-03-12,1903,Liverpool,Sheffield United,3-0,3,0,1,1,3,3,H,"Watson, Tom",3,Anfield
1904-03-19,1903,Newcastle United,Liverpool,1-1,1,1,1,1,2,0,D,"Watson, Tom",1,Away
1904-03-26,1903,Liverpool,Aston Villa,1-1,1,1,1,1,2,0,D,"Watson, Tom",1,Anfield
1904-04-01,1903,Everton,Liverpool,5-2,5,2,1,1,7,3,H,"Watson, Tom",2,Away
1904-04-02,1903,Middlesbrough,Liverpool,1-0,1,0,1,1,1,1,H,"Watson, Tom",0,Away
1904-04-16,1903,Liverpool,Bury,3-0,3,0,1,1,3,3,H,"Watson, Tom",3,Anfield
1904-04-23,1903,Blackburn Rovers,Liverpool,2-3,2,3,1,1,5,-1,A,"Watson, Tom",3,Away
1904-09-01,1904,Liverpool,Burton United,2-0,2,0,2,2,2,2,H,"Watson, Tom",2,Anfield
1904-09-03,1904,Liverpool,Glossop North End,2-2,2,2,2,2,4,0,D,"Watson, Tom",2,Anfield
1904-09-10,1904,Chesterfield,Liverpool,1-1,1,1,2,2,2,0,D,"Watson, Tom",1,Away
1904-09-17,1904,Liverpool,Bradford City,4-1,4,1,2,2,5,3,H,"Watson, Tom",4,Anfield
1904-09-24,1904,Lincoln City,Liverpool,0-2,0,2,2,2,2,-2,A,"Watson, Tom",2,Away
1904-10-01,1904,Liverpool,Leicester City,4-0,4,0,2,2,4,4,H,"Watson, Tom",4,Anfield
1904-10-08,1904,Barnsley,Liverpool,0-2,0,2,2,2,2,-2,A,"Watson, Tom",2,Away
1904-10-15,1904,Liverpool,West Bromwich Albion,3-2,3,2,2,2,5,1,H,"Watson, Tom",3,Anfield
1904-10-22,1904,Burnley,Liverpool,0-2,0,2,2,2,2,-2,A,"Watson, Tom",2,Away
1904-10-29,1904,Liverpool,Grimsby Town,5-0,5,0,2,2,5,5,H,"Watson, Tom",5,Anfield
1904-11-05,1904,Blackpool,Liverpool,0-3,0,3,2,2,3,-3,A,"Watson, Tom",3,Away
1904-11-12,1904,Port Vale,Liverpool,1-2,1,2,2,2,3,-1,A,"Watson, Tom",2,Away
1904-11-19,1904,Gainsborough Trinity,Liverpool,1-2,1,2,2,2,3,-1,A,"Watson, Tom",2,Away
1904-12-03,1904,Bolton Wanderers,Liverpool,2-0,2,0,2,2,2,2,H,"Watson, Tom",0,Away
1904-12-17,1904,Liverpool,Bristol City,3-1,3,1,2,2,4,2,H,"Watson, Tom",3,Anfield
1904-12-24,1904,Manchester United,Liverpool,3-1,3,1,2,2,4,2,H,"Watson, Tom",1,Away
1904-12-26,1904,Liverpool,Barnsley,2-1,2,1,2,2,3,1,H,"Watson, Tom",2,Anfield
1904-12-31,1904,Glossop North End,Liverpool,0-2,0,2,2,2,2,-2,A,"Watson, Tom",2,Away
1905-01-07,1904,Liverpool,Chesterfield,6-1,6,1,2,2,7,5,H,"Watson, Tom",6,Anfield
1905-01-21,1904,Liverpool,Lincoln City,1-1,1,1,2,2,2,0,D,"Watson, Tom",1,Anfield
1905-01-28,1904,Leicester City,Liverpool,0-3,0,3,2,2,3,-3,A,"Watson, Tom",3,Away
1905-02-11,1904,West Bromwich Albion,Liverpool,0-2,0,2,2,2,2,-2,A,"Watson, Tom",2,Away
1905-02-25,1904,Grimsby Town,Liverpool,0-1,0,1,2,2,1,-1,A,"Watson, Tom",1,Away
1905-03-04,1904,Liverpool,Blackpool,5-0,5,0,2,2,5,5,H,"Watson, Tom",5,Anfield
1905-03-07,1904,Bradford City,Liverpool,2-4,2,4,2,2,6,-2,A,"Watson, Tom",4,Away
1905-03-11,1904,Doncaster Rovers,Liverpool,1-4,1,4,2,2,5,-3,A,"Watson, Tom",4,Away
1905-03-18,1904,Liverpool,Gainsborough Trinity,6-1,6,1,2,2,7,5,H,"Watson, Tom",6,Anfield
1905-03-25,1904,Burton United,Liverpool,2-1,2,1,2,2,3,1,H,"Watson, Tom",1,Away
1905-04-01,1904,Liverpool,Bolton Wanderers,1-1,1,1,2,2,2,0,D,"Watson, Tom",1,Anfield
1905-04-08,1904,Liverpool,Port Vale,8-1,8,1,2,2,9,7,H,"Watson, Tom",8,Anfield
1905-04-15,1904,Bristol City,Liverpool,0-1,0,1,2,2,1,-1,A,"Watson, Tom",1,Away
1905-04-21,1904,Liverpool,Doncaster Rovers,1-0,1,0,2,2,1,1,H,"Watson, Tom",1,Anfield
1905-04-22,1904,Liverpool,Manchester United,4-0,4,0,2,2,4,4,H,"Watson, Tom",4,Anfield
1905-04-29,1904,Liverpool,Burnley,3-0,3,0,2,2,3,3,H,"Watson, Tom",3,Anfield
1905-09-02,1905,Arsenal,Liverpool,3-1,3,1,1,1,4,2,H,"Watson, Tom",1,Away
1905-09-09,1905,Liverpool,Blackburn Rovers,1-3,1,3,1,1,4,-2,A,"Watson, Tom",1,Anfield
1905-09-11,1905,Aston Villa,Liverpool,5-0,5,0,1,1,5,5,H,"Watson, Tom",0,Away
1905-09-16,1905,Sunderland,Liverpool,1-2,1,2,1,1,3,-1,A,"Watson, Tom",2,Away
1905-09-23,1905,Liverpool,Birmingham City,2-0,2,0,1,1,2,2,H,"Watson, Tom",2,Anfield
1905-09-30,1905,Everton,Liverpool,4-2,4,2,1,1,6,2,H,"Watson, Tom",2,Away
1905-10-07,1905,Liverpool,Derby County,4-1,4,1,1,1,5,3,H,"Watson, Tom",4,Anfield
1905-10-14,1905,Sheffield Wednesday,Liverpool,3-2,3,2,1,1,5,1,H,"Watson, Tom",2,Away
1905-10-21,1905,Liverpool,Nottingham Forest,4-1,4,1,1,1,5,3,H,"Watson, Tom",4,Anfield
1905-10-28,1905,Manchester City,Liverpool,0-1,0,1,1,1,1,-1,A,"Watson, Tom",1,Away
1905-11-04,1905,Liverpool,Bury,3-1,3,1,1,1,4,2,H,"Watson, Tom",3,Anfield
1905-11-11,1905,Middlesbrough,Liverpool,1-5,1,5,1,1,6,-4,A,"Watson, Tom",5,Away
1905-11-18,1905,Liverpool,Preston North End,1-1,1,1,1,1,2,0,D,"Watson, Tom",1,Anfield
1905-11-25,1905,Newcastle United,Liverpool,2-3,2,3,1,1,5,-1,A,"Watson, Tom",3,Away
1905-12-02,1905,Liverpool,Aston Villa,3-0,3,0,1,1,3,3,H,"Watson, Tom",3,Anfield
1905-12-09,1905,Liverpool,Wolverhampton Wanderers,4-0,4,0,1,1,4,4,H,"Watson, Tom",4,Anfield
1905-12-16,1905,Sheffield United,Liverpool,1-2,1,2,1,1,3,-1,A,"Watson, Tom",2,Away
1905-12-23,1905,Liverpool,Notts County,2-0,2,0,1,1,2,2,H,"Watson, Tom",2,Anfield
1905-12-25,1905,Liverpool,Bolton Wanderers,2-2,2,2,1,1,4,0,D,"Watson, Tom",2,Anfield
1905-12-26,1905,Stoke City,Liverpool,2-1,2,1,1,1,3,1,H,"Watson, Tom",1,Away
1905-12-30,1905,Liverpool,Arsenal,3-0,3,0,1,1,3,3,H,"Watson, Tom",3,Anfield
1906-01-01,1905,Liverpool,Stoke City,3-1,3,1,1,1,4,2,H,"Watson, Tom",3,Anfield
1906-01-06,1905,Blackburn Rovers,Liverpool,0-0,0,0,1,1,0,0,D,"Watson, Tom",0,Away
1906-01-20,1905,Liverpool,Sunderland,2-0,2,0,1,1,2,2,H,"Watson, Tom",2,Anfield
1906-01-27,1905,Birmingham City,Liverpool,1-0,1,0,1,1,1,1,H,"Watson, Tom",0,Away
1906-02-10,1905,Derby County,Liverpool,0-3,0,3,1,1,3,-3,A,"Watson, Tom",3,Away
1906-02-17,1905,Liverpool,Sheffield Wednesday,2-1,2,1,1,1,3,1,H,"Watson, Tom",2,Anfield
1906-03-03,1905,Liverpool,Manchester City,0-1,0,1,1,1,1,-1,A,"Watson, Tom",0,Anfield
1906-03-14,1905,Nottingham Forest,Liverpool,1-2,1,2,1,1,3,-1,A,"Watson, Tom",2,Away
1906-03-17,1905,Liverpool,Middlesbrough,6-1,6,1,1,1,7,5,H,"Watson, Tom",6,Anfield
1906-03-21,1905,Notts County,Liverpool,3-0,3,0,1,1,3,3,H,"Watson, Tom",0,Away
1906-03-24,1905,Preston North End,Liverpool,1-2,1,2,1,1,3,-1,A,"Watson, Tom",2,Away
1906-04-02,1905,Bury,Liverpool,0-0,0,0,1,1,0,0,D,"Watson, Tom",0,Away
1906-04-09,1905,Liverpool,Newcastle United,3-0,3,0,1,1,3,3,H,"Watson, Tom",3,Anfield
1906-04-13,1905,Liverpool,Everton,1-1,1,1,1,1,2,0,D,"Watson, Tom",1,Anfield
1906-04-14,1905,Wolverhampton Wanderers,Liverpool,0-2,0,2,1,1,2,-2,A,"Watson, Tom",2,Away
1906-04-16,1905,Bolton Wanderers,Liverpool,3-2,3,2,1,1,5,1,H,"Watson, Tom",2,Away
1906-04-21,1905,Liverpool,Sheffield United,3-1,3,1,1,1,4,2,H,"Watson, Tom",3,Anfield
1906-09-01,1906,Liverpool,Stoke City,1-0,1,0,1,1,1,1,H,"Watson, Tom",1,Anfield
1906-09-08,1906,Blackburn Rovers,Liverpool,1-1,1,1,1,1,2,0,D,"Watson, Tom",1,Away
1906-09-10,1906,Liverpool,Bury,2-2,2,2,1,1,4,0,D,"Watson, Tom",2,Anfield
1906-09-15,1906,Liverpool,Sunderland,1-2,1,2,1,1,3,-1,A,"Watson, Tom",1,Anfield
1906-09-22,1906,Birmingham City,Liverpool,2-1,2,1,1,1,3,1,H,"Watson, Tom",1,Away
1906-09-29,1906,Liverpool,Everton,1-2,1,2,1,1,3,-1,A,"Watson, Tom",1,Anfield
1906-10-06,1906,Arsenal,Liverpool,2-1,2,1,1,1,3,1,H,"Watson, Tom",1,Away
1906-10-13,1906,Liverpool,Sheffield Wednesday,1-2,1,2,1,1,3,-1,A,"Watson, Tom",1,Anfield
1906-10-20,1906,Bury,Liverpool,1-3,1,3,1,1,4,-2,A,"Watson, Tom",3,Away
1906-10-27,1906,Liverpool,Manchester City,5-4,5,4,1,1,9,1,H,"Watson, Tom",5,Anfield
1906-11-03,1906,Middlesbrough,Liverpool,0-1,0,1,1,1,1,-1,A,"Watson, Tom",1,Away
1906-11-10,1906,Liverpool,Preston North End,6-1,6,1,1,1,7,5,H,"Watson, Tom",6,Anfield
1906-11-17,1906,Newcastle United,Liverpool,2-0,2,0,1,1,2,2,H,"Watson, Tom",0,Away
1906-11-24,1906,Liverpool,Aston Villa,5-2,5,2,1,1,7,3,H,"Watson, Tom",5,Anfield
1906-12-01,1906,Derby County,Liverpool,0-1,0,1,1,1,1,-1,A,"Watson, Tom",1,Away
1906-12-08,1906,Bristol City,Liverpool,3-1,3,1,1,1,4,2,H,"Watson, Tom",1,Away
1906-12-15,1906,Liverpool,Notts County,5-1,5,1,1,1,6,4,H,"Watson, Tom",5,Anfield
1906-12-22,1906,Sheffield United,Liverpool,1-0,1,0,1,1,1,1,H,"Watson, Tom",0,Away
1906-12-25,1906,Manchester United,Liverpool,0-0,0,0,1,1,0,0,D,"Watson, Tom",0,Away
1906-12-26,1906,Liverpool,Bolton Wanderers,0-2,0,2,1,1,2,-2,A,"Watson, Tom",0,Anfield
1907-01-01,1906,Bolton Wanderers,Liverpool,3-0,3,0,1,1,3,3,H,"Watson, Tom",0,Away
1907-01-05,1906,Liverpool,Blackburn Rovers,0-2,0,2,1,1,2,-2,A,"Watson, Tom",0,Anfield
1907-01-19,1906,Sunderland,Liverpool,5-5,5,5,1,1,10,0,D,"Watson, Tom",5,Away
1907-01-26,1906,Liverpool,Birmingham City,2-0,2,0,1,1,2,2,H,"Watson, Tom",2,Anfield
1907-02-09,1906,Liverpool,Arsenal,4-0,4,0,1,1,4,4,H,"Watson, Tom",4,Anfield
1907-02-16,1906,Sheffield Wednesday,Liverpool,2-3,2,3,1,1,5,-1,A,"Watson, Tom",3,Away
1907-03-02,1906,Manchester City,Liverpool,1-0,1,0,1,1,1,1,H,"Watson, Tom",0,Away
1907-03-11,1906,Stoke City,Liverpool,1-1,1,1,1,1,2,0,D,"Watson, Tom",1,Away
1907-03-16,1906,Preston North End,Liverpool,3-1,3,1,1,1,4,2,H,"Watson, Tom",1,Away
1907-03-23,1906,Liverpool,Newcastle United,4-1,4,1,1,1,5,3,H,"Watson, Tom",4,Anfield
1907-03-29,1906,Everton,Liverpool,0-0,0,0,1,1,0,0,D,"Watson, Tom",0,Away
1907-03-30,1906,Aston Villa,Liverpool,4-0,4,0,1,1,4,4,H,"Watson, Tom",0,Away
1907-04-01,1906,Liverpool,Manchester United,0-1,0,1,1,1,1,-1,A,"Watson, Tom",0,Anfield
1907-04-06,1906,Liverpool,Derby County,2-0,2,0,1,1,2,2,H,"Watson, Tom",2,Anfield
1907-04-13,1906,Liverpool,Bristol City,2-4,2,4,1,1,6,-2,A,"Watson, Tom",2,Anfield
1907-04-17,1906,Liverpool,Middlesbrough,2-4,2,4,1,1,6,-2,A,"Watson, Tom",2,Anfield
1907-04-20,1906,Notts County,Liverpool,2-0,2,0,1,1,2,2,H,"Watson, Tom",0,Away
1907-04-27,1906,Liverpool,Sheffield United,2-2,2,2,1,1,4,0,D,"Watson, Tom",2,Anfield
1907-09-02,1907,Nottingham Forest,Liverpool,3-1,3,1,1,1,4,2,H,"Watson, Tom",1,Away
1907-09-07,1907,Manchester United,Liverpool,4-0,4,0,1,1,4,4,H,"Watson, Tom",0,Away
1907-09-14,1907,Liverpool,Blackburn Rovers,2-0,2,0,1,1,2,2,H,"Watson, Tom",2,Anfield
1907-09-16,1907,Sheffield United,Liverpool,0-0,0,0,1,1,0,0,D,"Watson, Tom",0,Away
1907-09-21,1907,Bolton Wanderers,Liverpool,0-4,0,4,1,1,4,-4,A,"Watson, Tom",4,Away
1907-09-28,1907,Liverpool,Birmingham City,3-4,3,4,1,1,7,-1,A,"Watson, Tom",3,Anfield
1907-10-05,1907,Everton,Liverpool,2-4,2,4,1,1,6,-2,A,"Watson, Tom",4,Away
1907-10-12,1907,Liverpool,Sunderland,1-0,1,0,1,1,1,1,H,"Watson, Tom",1,Anfield
1907-10-19,1907,Arsenal,Liverpool,2-1,2,1,1,1,3,1,H,"Watson, Tom",1,Away
1907-10-26,1907,Liverpool,Sheffield Wednesday,3-0,3,0,1,1,3,3,H,"Watson, Tom",3,Anfield
1907-11-02,1907,Bristol City,Liverpool,2-0,2,0,1,1,2,2,H,"Watson, Tom",0,Away
1907-11-09,1907,Liverpool,Notts County,6-0,6,0,1,1,6,6,H,"Watson, Tom",6,Anfield
1907-11-16,1907,Manchester City,Liverpool,1-1,1,1,1,1,2,0,D,"Watson, Tom",1,Away
1907-11-23,1907,Liverpool,Preston North End,1-2,1,2,1,1,3,-1,A,"Watson, Tom",1,Anfield
1907-12-07,1907,Liverpool,Aston Villa,5-0,5,0,1,1,5,5,H,"Watson, Tom",5,Anfield
1907-12-14,1907,Liverpool,Newcastle United,1-5,1,5,1,1,6,-4,A,"Watson, Tom",1,Anfield
1907-12-21,1907,Middlesbrough,Liverpool,3-1,3,1,1,1,4,2,H,"Watson, Tom",1,Away
1907-12-25,1907,Liverpool,Chelsea,1-4,1,4,1,1,5,-3,A,"Watson, Tom",1,Anfield
1907-12-28,1907,Liverpool,Sheffield United,3-0,3,0,1,1,3,3,H,"Watson, Tom",3,Anfield
1908-01-01,1907,Liverpool,Nottingham Forest,0-0,0,0,1,1,0,0,D,"Watson, Tom",0,Anfield
1908-01-18,1907,Liverpool,Bolton Wanderers,1-0,1,0,1,1,1,1,H,"Watson, Tom",1,Anfield
1908-01-25,1907,Birmingham City,Liverpool,1-1,1,1,1,1,2,0,D,"Watson, Tom",1,Away
1908-02-08,1907,Sunderland,Liverpool,1-0,1,0,1,1,1,1,H,"Watson, Tom",0,Away
1908-02-15,1907,Liverpool,Arsenal,4-1,4,1,1,1,5,3,H,"Watson, Tom",4,Anfield
1908-02-29,1907,Liverpool,Bristol City,3-1,3,1,1,1,4,2,H,"Watson, Tom",3,Anfield
1908-03-07,1907,Notts County,Liverpool,2-2,2,2,1,1,4,0,D,"Watson, Tom",2,Away
1908-03-09,1907,Sheffield Wednesday,Liverpool,1-2,1,2,1,1,3,-1,A,"Watson, Tom",2,Away
1908-03-14,1907,Liverpool,Manchester City,0-1,0,1,1,1,1,-1,A,"Watson, Tom",0,Anfield
1908-03-21,1907,Preston North End,Liverpool,3-0,3,0,1,1,3,3,H,"Watson, Tom",0,Away
1908-03-25,1907,Liverpool,Manchester United,7-4,7,4,1,1,11,3,H,"Watson, Tom",7,Anfield
1908-03-28,1907,Bury,Liverpool,3-1,3,1,1,1,4,2,H,"Watson, Tom",1,Away
1908-04-04,1907,Aston Villa,Liverpool,5-1,5,1,1,1,6,4,H,"Watson, Tom",1,Away
1908-04-06,1907,Blackburn Rovers,Liverpool,1-3,1,3,1,1,4,-2,A,"Watson, Tom",3,Away
1908-04-11,1907,Newcastle United,Liverpool,3-1,3,1,1,1,4,2,H,"Watson, Tom",1,Away
1908-04-17,1907,Liverpool,Everton,0-0,0,0,1,1,0,0,D,"Watson, Tom",0,Anfield
1908-04-18,1907,Liverpool,Middlesbrough,0-1,0,1,1,1,1,-1,A,"Watson, Tom",0,Anfield
1908-04-20,1907,Chelsea,Liverpool,0-2,0,2,1,1,2,-2,A,"Watson, Tom",2,Away
1908-04-27,1907,Liverpool,Bury,2-1,2,1,1,1,3,1,H,"Watson, Tom",2,Anfield
1908-09-01,1908,Liverpool,Aston Villa,3-2,3,2,1,1,5,1,H,"Watson, Tom",3,Anfield
1908-09-05,1908,Liverpool,Chelsea,2-1,2,1,1,1,3,1,H,"Watson, Tom",2,Anfield
1908-09-12,1908,Blackburn Rovers,Liverpool,1-0,1,0,1,1,1,1,H,"Watson, Tom",0,Away
1908-09-14,1908,Sheffield United,Liverpool,0-2,0,2,1,1,2,-2,A,"Watson, Tom",2,Away
1908-09-19,1908,Liverpool,Bradford City,4-0,4,0,1,1,4,4,H,"Watson, Tom",4,Anfield
1908-09-26,1908,Manchester United,Liverpool,3-2,3,2,1,1,5,1,H,"Watson, Tom",2,Away
1908-10-01,1908,Nottingham Forest,Liverpool,5-1,5,1,1,1,6,4,H,"Watson, Tom",1,Away
1908-10-03,1908,Liverpool,Everton,0-1,0,1,1,1,1,-1,A,"Watson, Tom",0,Anfield
1908-10-10,1908,Leicester City,Liverpool,3-2,3,2,1,1,5,1,H,"Watson, Tom",2,Away
1908-10-17,1908,Liverpool,Arsenal,2-2,2,2,1,1,4,0,D,"Watson, Tom",2,Anfield
1908-10-24,1908,Notts County,Liverpool,1-2,1,2,1,1,3,-1,A,"Watson, Tom",2,Away
1908-10-31,1908,Liverpool,Newcastle United,2-1,2,1,1,1,3,1,H,"Watson, Tom",2,Anfield
1908-11-07,1908,Bristol City,Liverpool,1-0,1,0,1,1,1,1,H,"Watson, Tom",0,Away
1908-11-14,1908,Liverpool,Preston North End,2-1,2,1,1,1,3,1,H,"Watson, Tom",2,Anfield
1908-11-21,1908,Middlesbrough,Liverpool,1-0,1,0,1,1,1,1,H,"Watson, Tom",0,Away
1908-11-28,1908,Liverpool,Manchester City,1-3,1,3,1,1,4,-2,A,"Watson, Tom",1,Anfield
1908-12-05,1908,Sheffield Wednesday,Liverpool,2-3,2,3,1,1,5,-1,A,"Watson, Tom",3,Away
1908-12-12,1908,Bury,Liverpool,2-1,2,1,1,1,3,1,H,"Watson, Tom",1,Away
1908-12-19,1908,Liverpool,Sheffield United,2-1,2,1,1,1,3,1,H,"Watson, Tom",2,Anfield
1908-12-25,1908,Aston Villa,Liverpool,1-1,1,1,1,1,2,0,D,"Watson, Tom",1,Away
1908-12-26,1908,Liverpool,Nottingham Forest,1-1,1,1,1,1,2,0,D,"Watson, Tom",1,Anfield
1909-01-01,1908,Sunderland,Liverpool,1-4,1,4,1,1,5,-3,A,"Watson, Tom",4,Away
1909-01-02,1908,Chelsea,Liverpool,3-0,3,0,1,1,3,3,H,"Watson, Tom",0,Away
1909-01-09,1908,Liverpool,Blackburn Rovers,1-1,1,1,1,1,2,0,D,"Watson, Tom",1,Anfield
1909-01-23,1908,Bradford City,Liverpool,0-2,0,2,1,1,2,-2,A,"Watson, Tom",2,Away
1909-01-30,1908,Liverpool,Manchester United,3-1,3,1,1,1,4,2,H,"Watson, Tom",3,Anfield
1909-02-13,1908,Liverpool,Leicester City,4-1,4,1,1,1,5,3,H,"Watson, Tom",4,Anfield
1909-02-20,1908,Arsenal,Liverpool,5-0,5,0,1,1,5,5,H,"Watson, Tom",0,Away
1909-02-27,1908,Liverpool,Notts County,1-1,1,1,1,1,2,0,D,"Watson, Tom",1,Anfield
1909-03-13,1908,Liverpool,Bristol City,1-2,1,2,1,1,3,-1,A,"Watson, Tom",1,Anfield
1909-03-20,1908,Preston North End,Liverpool,2-0,2,0,1,1,2,2,H,"Watson, Tom",0,Away
1909-03-27,1908,Liverpool,Middlesbrough,1-2,1,2,1,1,3,-1,A,"Watson, Tom",1,Anfield
1909-04-03,1908,Manchester City,Liverpool,4-0,4,0,1,1,4,4,H,"Watson, Tom",0,Away
1909-04-09,1908,Everton,Liverpool,5-0,5,0,1,1,5,5,H,"Watson, Tom",0,Away
1909-04-10,1908,Liverpool,Sheffield Wednesday,1-2,1,2,1,1,3,-1,A,"Watson, Tom",1,Anfield
1909-04-12,1908,Liverpool,Sunderland,3-0,3,0,1,1,3,3,H,"Watson, Tom",3,Anfield
1909-04-17,1908,Liverpool,Bury,2-2,2,2,1,1,4,0,D,"Watson, Tom",2,Anfield
1909-04-30,1908,Newcastle United,Liverpool,0-1,0,1,1,1,1,-1,A,"Watson, Tom",1,Away
1909-09-04,1909,Chelsea,Liverpool,2-1,2,1,1,1,3,1,H,"Watson, Tom",1,Away
1909-09-06,1909,Bolton Wanderers,Liverpool,1-2,1,2,1,1,3,-1,A,"Watson, Tom",2,Away
1909-09-11,1909,Liverpool,Blackburn Rovers,3-1,3,1,1,1,4,2,H,"Watson, Tom",3,Anfield
1909-09-18,1909,Nottingham Forest,Liverpool,1-4,1,4,1,1,5,-3,A,"Watson, Tom",4,Away
1909-09-25,1909,Liverpool,Sunderland,1-4,1,4,1,1,5,-3,A,"Watson, Tom",1,Anfield
1909-10-02,1909,Everton,Liverpool,2-3,2,3,1,1,5,-1,A,"Watson, Tom",3,Away
1909-10-09,1909,Liverpool,Manchester United,3-2,3,2,1,1,5,1,H,"Watson, Tom",3,Anfield
1909-10-16,1909,Bradford City,Liverpool,1-2,1,2,1,1,3,-1,A,"Watson, Tom",2,Away
1909-10-23,1909,Liverpool,Sheffield Wednesday,3-1,3,1,1,1,4,2,H,"Watson, Tom",3,Anfield
1909-10-30,1909,Bristol City,Liverpool,0-1,0,1,1,1,1,-1,A,"Watson, Tom",1,Away
1909-11-06,1909,Liverpool,Bury,2-2,2,2,1,1,4,0,D,"Watson, Tom",2,Anfield
1909-11-13,1909,Tottenham Hotspur,Liverpool,1-0,1,0,1,1,1,1,H,"Watson, Tom",0,Away
1909-11-20,1909,Liverpool,Preston North End,2-0,2,0,1,1,2,2,H,"Watson, Tom",2,Anfield
1909-11-27,1909,Notts County,Liverpool,3-1,3,1,1,1,4,2,H,"Watson, Tom",1,Away
1909-12-04,1909,Liverpool,Newcastle United,6-5,6,5,1,1,11,1,H,"Watson, Tom",6,Anfield
1909-12-11,1909,Liverpool,Middlesbrough,0-0,0,0,1,1,0,0,D,"Watson, Tom",0,Anfield
1909-12-18,1909,Aston Villa,Liverpool,3-1,3,1,1,1,4,2,H,"Watson, Tom",1,Away
1909-12-25,1909,Liverpool,Bolton Wanderers,3-0,3,0,1,1,3,3,H,"Watson, Tom",3,Anfield
1909-12-27,1909,Arsenal,Liverpool,1-1,1,1,1,1,2,0,D,"Watson, Tom",1,Away
1909-12-28,1909,Sheffield United,Liverpool,4-2,4,2,1,1,6,2,H,"Watson, Tom",2,Away
1910-01-01,1909,Liverpool,Arsenal,5-1,5,1,1,1,6,4,H,"Watson, Tom",5,Anfield
1910-01-08,1909,Liverpool,Chelsea,5-1,5,1,1,1,6,4,H,"Watson, Tom",5,Anfield
1910-01-22,1909,Blackburn Rovers,Liverpool,1-1,1,1,1,1,2,0,D,"Watson, Tom",1,Away
1910-02-12,1909,Liverpool,Everton,0-1,0,1,1,1,1,-1,A,"Watson, Tom",0,Anfield
1910-02-19,1909,Manchester United,Liverpool,3-4,3,4,1,1,7,-1,A,"Watson, Tom",4,Away
1910-02-26,1909,Liverpool,Bradford City,1-0,1,0,1,1,1,1,H,"Watson, Tom",1,Anfield
1910-03-05,1909,Sheffield Wednesday,Liverpool,3-0,3,0,1,1,3,3,H,"Watson, Tom",0,Away
1910-03-12,1909,Liverpool,Bristol City,0-1,0,1,1,1,1,-1,A,"Watson, Tom",0,Anfield
1910-03-19,1909,Bury,Liverpool,1-2,1,2,1,1,3,-1,A,"Watson, Tom",2,Away
1910-03-25,1909,Liverpool,Sheffield United,0-0,0,0,1,1,0,0,D,"Watson, Tom",0,Anfield
1910-03-26,1909,Liverpool,Tottenham Hotspur,2-0,2,0,1,1,2,2,H,"Watson, Tom",2,Anfield
1910-03-28,1909,Sunderland,Liverpool,2-1,2,1,1,1,3,1,H,"Watson, Tom",1,Away
1910-04-02,1909,Preston North End,Liverpool,2-0,2,0,1,1,2,2,H,"Watson, Tom",0,Away
1910-04-09,1909,Liverpool,Notts County,2-1,2,1,1,1,3,1,H,"Watson, Tom",2,Anfield
1910-04-16,1909,Newcastle United,Liverpool,1-3,1,3,1,1,4,-2,A,"Watson, Tom",3,Away
1910-04-20,1909,Liverpool,Nottingham Forest,7-3,7,3,1,1,10,4,H,"Watson, Tom",7,Anfield
1910-04-23,1909,Middlesbrough,Liverpool,2-2,2,2,1,1,4,0,D,"Watson, Tom",2,Away
1910-04-30,1909,Liverpool,Aston Villa,2-0,2,0,1,1,2,2,H,"Watson, Tom",2,Anfield
1910-09-03,1910,Liverpool,Bradford City,1-2,1,2,1,1,3,-1,A,"Watson, Tom",1,Anfield
1910-09-10,1910,Blackburn Rovers,Liverpool,1-2,1,2,1,1,3,-1,A,"Watson, Tom",2,Away
1910-09-17,1910,Liverpool,Nottingham Forest,2-3,2,3,1,1,5,-1,A,"Watson, Tom",2,Anfield
1910-09-19,1910,Sheffield United,Liverpool,2-0,2,0,1,1,2,2,H,"Watson, Tom",0,Away
1910-09-24,1910,Manchester City,Liverpool,1-2,1,2,1,1,3,-1,A,"Watson, Tom",2,Away
1910-10-01,1910,Liverpool,Everton,0-2,0,2,1,1,2,-2,A,"Watson, Tom",0,Anfield
1910-10-08,1910,Sheffield Wednesday,Liverpool,1-0,1,0,1,1,1,1,H,"Watson, Tom",0,Away
1910-10-15,1910,Liverpool,Bristol City,4-0,4,0,1,1,4,4,H,"Watson, Tom",4,Anfield
1910-10-22,1910,Newcastle United,Liverpool,6-1,6,1,1,1,7,5,H,"Watson, Tom",1,Away
1910-10-29,1910,Liverpool,Tottenham Hotspur,1-2,1,2,1,1,3,-1,A,"Watson, Tom",1,Anfield
1910-11-05,1910,Middlesbrough,Liverpool,2-2,2,2,1,1,4,0,D,"Watson, Tom",2,Away
1910-11-12,1910,Liverpool,Preston North End,3-0,3,0,1,1,3,3,H,"Watson, Tom",3,Anfield
1910-11-19,1910,Notts County,Liverpool,1-0,1,0,1,1,1,1,H,"Watson, Tom",0,Away
1910-11-26,1910,Liverpool,Manchester United,3-2,3,2,1,1,5,1,H,"Watson, Tom",3,Anfield
1910-12-03,1910,Oldham Athletic,Liverpool,3-1,3,1,1,1,4,2,H,"Watson, Tom",1,Away
1910-12-10,1910,Bury,Liverpool,3-0,3,0,1,1,3,3,H,"Watson, Tom",0,Away
1910-12-17,1910,Liverpool,Sheffield United,2-0,2,0,1,1,2,2,H,"Watson, Tom",2,Anfield
1910-12-24,1910,Aston Villa,Liverpool,1-1,1,1,1,1,2,0,D,"Watson, Tom",1,Away
1910-12-26,1910,Liverpool,Sunderland,1-2,1,2,1,1,3,-1,A,"Watson, Tom",1,Anfield
1910-12-27,1910,Everton,Liverpool,0-1,0,1,1,1,1,-1,A,"Watson, Tom",1,Away
1910-12-31,1910,Bradford City,Liverpool,1-3,1,3,1,1,4,-2,A,"Watson, Tom",3,Away
1911-01-02,1910,Sunderland,Liverpool,4-0,4,0,1,1,4,4,H,"Watson, Tom",0,Away
1911-01-07,1910,Liverpool,Blackburn Rovers,2-2,2,2,1,1,4,0,D,"Watson, Tom",2,Anfield
1911-01-21,1910,Nottingham Forest,Liverpool,2-0,2,0,1,1,2,2,H,"Watson, Tom",0,Away
1911-01-28,1910,Liverpool,Manchester City,1-1,1,1,1,1,2,0,D,"Watson, Tom",1,Anfield
1911-02-11,1910,Liverpool,Sheffield Wednesday,3-0,3,0,1,1,3,3,H,"Watson, Tom",3,Anfield
1911-02-18,1910,Bristol City,Liverpool,1-1,1,1,1,1,2,0,D,"Watson, Tom",1,Away
1911-02-27,1910,Liverpool,Newcastle United,3-0,3,0,1,1,3,3,H,"Watson, Tom",3,Anfield
1911-03-04,1910,Tottenham Hotspur,Liverpool,1-0,1,0,1,1,1,1,H,"Watson, Tom",0,Away
1911-03-11,1910,Liverpool,Middlesbrough,3-0,3,0,1,1,3,3,H,"Watson, Tom",3,Anfield
1911-03-18,1910,Preston North End,Liverpool,2-1,2,1,1,1,3,1,H,"Watson, Tom",1,Away
1911-03-25,1910,Liverpool,Notts County,2-1,2,1,1,1,3,1,H,"Watson, Tom",2,Anfield
1911-04-01,1910,Manchester United,Liverpool,2-0,2,0,1,1,2,2,H,"Watson, Tom",0,Away
1911-04-08,1910,Liverpool,Oldham Athletic,1-0,1,0,1,1,1,1,H,"Watson, Tom",1,Anfield
1911-04-14,1910,Arsenal,Liverpool,0-0,0,0,1,1,0,0,D,"Watson, Tom",0,Away
1911-04-15,1910,Liverpool,Bury,2-0,2,0,1,1,2,2,H,"Watson, Tom",2,Anfield
1911-04-17,1910,Liverpool,Arsenal,1-1,1,1,1,1,2,0,D,"Watson, Tom",1,Anfield
1911-04-29,1910,Liverpool,Aston Villa,3-1,3,1,1,1,4,2,H,"Watson, Tom",3,Anfield
1911-09-02,1911,Arsenal,Liverpool,2-2,2,2,1,1,4,0,D,"Watson, Tom",2,Away
1911-09-04,1911,Bolton Wanderers,Liverpool,2-1,2,1,1,1,3,1,H,"Watson, Tom",1,Away
1911-09-09,1911,Liverpool,Manchester City,2-2,2,2,1,1,4,0,D,"Watson, Tom",2,Anfield
1911-09-16,1911,Everton,Liverpool,2-1,2,1,1,1,3,1,H,"Watson, Tom",1,Away
1911-09-23,1911,Liverpool,West Bromwich Albion,1-3,1,3,1,1,4,-2,A,"Watson, Tom",1,Anfield
1911-09-30,1911,Sunderland,Liverpool,1-2,1,2,1,1,3,-1,A,"Watson, Tom",2,Away
1911-10-07,1911,Liverpool,Blackburn Rovers,1-2,1,2,1,1,3,-1,A,"Watson, Tom",1,Anfield
1911-10-14,1911,Sheffield Wednesday,Liverpool,2-2,2,2,1,1,4,0,D,"Watson, Tom",2,Away
1911-10-21,1911,Liverpool,Bury,1-1,1,1,1,1,2,0,D,"Watson, Tom",1,Anfield
1911-10-28,1911,Middlesbrough,Liverpool,3-2,3,2,1,1,5,1,H,"Watson, Tom",2,Away
1911-11-04,1911,Liverpool,Notts County,3-0,3,0,1,1,3,3,H,"Watson, Tom",3,Anfield
1911-11-11,1911,Tottenham Hotspur,Liverpool,2-0,2,0,1,1,2,2,H,"Watson, Tom",0,Away
1911-11-18,1911,Liverpool,Manchester United,3-2,3,2,1,1,5,1,H,"Watson, Tom",3,Anfield
1911-11-25,1911,Liverpool,Preston North End,0-1,0,1,1,1,1,-1,A,"Watson, Tom",0,Anfield
1911-12-02,1911,Aston Villa,Liverpool,5-0,5,0,1,1,5,5,H,"Watson, Tom",0,Away
1911-12-09,1911,Liverpool,Newcastle United,0-1,0,1,1,1,1,-1,A,"Watson, Tom",0,Anfield
1911-12-16,1911,Sheffield United,Liverpool,3-1,3,1,1,1,4,2,H,"Watson, Tom",1,Away
1911-12-23,1911,Liverpool,Oldham Athletic,1-0,1,0,1,1,1,1,H,"Watson, Tom",1,Anfield
1911-12-25,1911,Liverpool,Bolton Wanderers,1-0,1,0,1,1,1,1,H,"Watson, Tom",1,Anfield
1911-12-30,1911,Liverpool,Arsenal,4-1,4,1,1,1,5,3,H,"Watson, Tom",4,Anfield
1912-01-01,1911,Liverpool,Bradford City,1-0,1,0,1,1,1,1,H,"Watson, Tom",1,Anfield
1912-01-06,1911,Manchester City,Liverpool,2-3,2,3,1,1,5,-1,A,"Watson, Tom",3,Away
1912-01-20,1911,Liverpool,Everton,1-3,1,3,1,1,4,-2,A,"Watson, Tom",1,Anfield
1912-01-27,1911,West Bromwich Albion,Liverpool,1-0,1,0,1,1,1,1,H,"Watson, Tom",0,Away
1912-02-10,1911,Blackburn Rovers,Liverpool,1-0,1,0,1,1,1,1,H,"Watson, Tom",0,Away
1912-02-17,1911,Liverpool,Sheffield Wednesday,1-1,1,1,1,1,2,0,D,"Watson, Tom",1,Anfield
1912-02-24,1911,Bury,Liverpool,2-2,2,2,1,1,4,0,D,"Watson, Tom",2,Away
1912-03-02,1911,Liverpool,Middlesbrough,1-1,1,1,1,1,2,0,D,"Watson, Tom",1,Anfield
1912-03-09,1911,Notts County,Liverpool,0-0,0,0,1,1,0,0,D,"Watson, Tom",0,Away
1912-03-16,1911,Liverpool,Tottenham Hotspur,1-2,1,2,1,1,3,-1,A,"Watson, Tom",1,Anfield
1912-03-23,1911,Manchester United,Liverpool,1-1,1,1,1,1,2,0,D,"Watson, Tom",1,Away
1912-03-30,1911,Preston North End,Liverpool,2-1,2,1,1,1,3,1,H,"Watson, Tom",1,Away
1912-04-05,1911,Liverpool,Sunderland,2-1,2,1,1,1,3,1,H,"Watson, Tom",2,Anfield
1912-04-06,1911,Liverpool,Aston Villa,1-2,1,2,1,1,3,-1,A,"Watson, Tom",1,Anfield
1912-04-08,1911,Bradford City,Liverpool,0-2,0,2,1,1,2,-2,A,"Watson, Tom",2,Away
1912-04-13,1911,Newcastle United,Liverpool,1-1,1,1,1,1,2,0,D,"Watson, Tom",1,Away
1912-04-20,1911,Liverpool,Sheffield United,2-0,2,0,1,1,2,2,H,"Watson, Tom",2,Anfield
1912-04-27,1911,Oldham Athletic,Liverpool,0-1,0,1,1,1,1,-1,A,"Watson, Tom",1,Away
1912-09-04,1912,Liverpool,Oldham Athletic,2-0,2,0,1,1,2,2,H,"Watson, Tom",2,Anfield
1912-09-07,1912,Liverpool,Arsenal,3-0,3,0,1,1,3,3,H,"Watson, Tom",3,Anfield
1912-09-09,1912,Chelsea,Liverpool,1-2,1,2,1,1,3,-1,A,"Watson, Tom",2,Away
1912-09-14,1912,Bradford City,Liverpool,2-0,2,0,1,1,2,2,H,"Watson, Tom",0,Away
1912-09-21,1912,Liverpool,Manchester City,1-2,1,2,1,1,3,-1,A,"Watson, Tom",1,Anfield
1912-09-28,1912,West Bromwich Albion,Liverpool,3-1,3,1,1,1,4,2,H,"Watson, Tom",1,Away
1912-10-05,1912,Liverpool,Everton,0-2,0,2,1,1,2,-2,A,"Watson, Tom",0,Anfield
1912-10-12,1912,Sheffield Wednesday,Liverpool,1-0,1,0,1,1,1,1,H,"Watson, Tom",0,Away
1912-10-14,1912,Sheffield United,Liverpool,4-1,4,1,1,1,5,3,H,"Watson, Tom",1,Away
1912-10-19,1912,Liverpool,Blackburn Rovers,4-1,4,1,1,1,5,3,H,"Watson, Tom",4,Anfield
1912-10-26,1912,Derby County,Liverpool,4-2,4,2,1,1,6,2,H,"Watson, Tom",2,Away
1912-11-02,1912,Liverpool,Tottenham Hotspur,4-1,4,1,1,1,5,3,H,"Watson, Tom",4,Anfield
1912-11-09,1912,Middlesbrough,Liverpool,3-4,3,4,1,1,7,-1,A,"Watson, Tom",4,Away
1912-11-16,1912,Liverpool,Notts County,0-0,0,0,1,1,0,0,D,"Watson, Tom",0,Anfield
1912-11-23,1912,Manchester United,Liverpool,3-1,3,1,1,1,4,2,H,"Watson, Tom",1,Away
1912-11-30,1912,Liverpool,Aston Villa,2-0,2,0,1,1,2,2,H,"Watson, Tom",2,Anfield
1912-12-07,1912,Sunderland,Liverpool,7-0,7,0,1,1,7,7,H,"Watson, Tom",0,Away
1912-12-14,1912,Bolton Wanderers,Liverpool,1-1,1,1,1,1,2,0,D,"Watson, Tom",1,Away
1912-12-21,1912,Liverpool,Sheffield United,2-2,2,2,1,1,4,0,D,"Watson, Tom",2,Anfield
1912-12-26,1912,Liverpool,Newcastle United,2-1,2,1,1,1,3,1,H,"Watson, Tom",2,Anfield
1912-12-28,1912,Arsenal,Liverpool,1-1,1,1,1,1,2,0,D,"Watson, Tom",1,Away
1913-01-01,1912,Newcastle United,Liverpool,0-0,0,0,1,1,0,0,D,"Watson, Tom",0,Away
1913-01-04,1912,Liverpool,Bradford City,2-1,2,1,1,1,3,1,H,"Watson, Tom",2,Anfield
1913-01-18,1912,Manchester City,Liverpool,4-1,4,1,1,1,5,3,H,"Watson, Tom",1,Away
1913-01-25,1912,Liverpool,West Bromwich Albion,2-1,2,1,1,1,3,1,H,"Watson, Tom",2,Anfield
1913-02-08,1912,Everton,Liverpool,0-2,0,2,1,1,2,-2,A,"Watson, Tom",2,Away
1913-02-10,1912,Oldham Athletic,Liverpool,3-1,3,1,1,1,4,2,H,"Watson, Tom",1,Away
1913-02-15,1912,Liverpool,Sheffield Wednesday,2-1,2,1,1,1,3,1,H,"Watson, Tom",2,Anfield
1913-03-01,1912,Liverpool,Derby County,2-1,2,1,1,1,3,1,H,"Watson, Tom",2,Anfield
1913-03-08,1912,Tottenham Hotspur,Liverpool,1-0,1,0,1,1,1,1,H,"Watson, Tom",0,Away
1913-03-10,1912,Blackburn Rovers,Liverpool,5-1,5,1,1,1,6,4,H,"Watson, Tom",1,Away
1913-03-15,1912,Liverpool,Middlesbrough,4-2,4,2,1,1,6,2,H,"Watson, Tom",4,Anfield
1913-03-22,1912,Notts County,Liverpool,3-0,3,0,1,1,3,3,H,"Watson, Tom",0,Away
1913-03-24,1912,Liverpool,Chelsea,1-2,1,2,1,1,3,-1,A,"Watson, Tom",1,Anfield
1913-03-29,1912,Liverpool,Manchester United,0-2,0,2,1,1,2,-2,A,"Watson, Tom",0,Anfield
1913-04-05,1912,Aston Villa,Liverpool,1-3,1,3,1,1,4,-2,A,"Watson, Tom",3,Away
1913-04-12,1912,Liverpool,Sunderland,2-5,2,5,1,1,7,-3,A,"Watson, Tom",2,Anfield
1913-04-19,1912,Liverpool,Bolton Wanderers,5-0,5,0,1,1,5,5,H,"Watson, Tom",5,Anfield
1913-09-01,1913,Derby County,Liverpool,1-1,1,1,1,1,2,0,D,"Watson, Tom",1,Away
1913-09-06,1913,Blackburn Rovers,Liverpool,6-2,6,2,1,1,8,4,H,"Watson, Tom",2,Away
1913-09-13,1913,Liverpool,Sunderland,1-3,1,3,1,1,4,-2,A,"Watson, Tom",1,Anfield
1913-09-20,1913,Everton,Liverpool,1-2,1,2,1,1,3,-1,A,"Watson, Tom",2,Away
1913-09-27,1913,Liverpool,West Bromwich Albion,0-0,0,0,1,1,0,0,D,"Watson, Tom",0,Anfield
1913-10-04,1913,Sheffield Wednesday,Liverpool,4-1,4,1,1,1,5,3,H,"Watson, Tom",1,Away
1913-10-11,1913,Liverpool,Bolton Wanderers,2-1,2,1,1,1,3,1,H,"Watson, Tom",2,Anfield
1913-10-18,1913,Chelsea,Liverpool,3-0,3,0,1,1,3,3,H,"Watson, Tom",0,Away
1913-10-25,1913,Liverpool,Oldham Athletic,0-3,0,3,1,1,3,-3,A,"Watson, Tom",0,Anfield
1913-11-01,1913,Manchester United,Liverpool,3-0,3,0,1,1,3,3,H,"Watson, Tom",0,Away
1913-11-08,1913,Liverpool,Burnley,1-1,1,1,1,1,2,0,D,"Watson, Tom",1,Anfield
1913-11-15,1913,Preston North End,Liverpool,0-1,0,1,1,1,1,-1,A,"Watson, Tom",1,Away
1913-11-22,1913,Liverpool,Newcastle United,0-0,0,0,1,1,0,0,D,"Watson, Tom",0,Anfield
1913-11-29,1913,Liverpool,Tottenham Hotspur,2-1,2,1,1,1,3,1,H,"Watson, Tom",2,Anfield
1913-12-06,1913,Aston Villa,Liverpool,2-1,2,1,1,1,3,1,H,"Watson, Tom",1,Away
1913-12-13,1913,Liverpool,Middlesbrough,2-1,2,1,1,1,3,1,H,"Watson, Tom",2,Anfield
1913-12-20,1913,Sheffield United,Liverpool,0-1,0,1,1,1,1,-1,A,"Watson, Tom",1,Away
1913-12-25,1913,Liverpool,Manchester City,4-2,4,2,1,1,6,2,H,"Watson, Tom",4,Anfield
1913-12-26,1913,Manchester City,Liverpool,1-0,1,0,1,1,1,1,H,"Watson, Tom",0,Away
1913-12-27,1913,Liverpool,Blackburn Rovers,3-3,3,3,1,1,6,0,D,"Watson, Tom",3,Anfield
1914-01-01,1913,Liverpool,Bradford City,0-1,0,1,1,1,1,-1,A,"Watson, Tom",0,Anfield
1914-01-03,1913,Sunderland,Liverpool,1-2,1,2,1,1,3,-1,A,"Watson, Tom",2,Away
1914-01-17,1913,Liverpool,Everton,1-2,1,2,1,1,3,-1,A,"Watson, Tom",1,Anfield
1914-01-24,1913,West Bromwich Albion,Liverpool,0-1,0,1,1,1,1,-1,A,"Watson, Tom",1,Away
1914-02-07,1913,Liverpool,Sheffield Wednesday,1-2,1,2,1,1,3,-1,A,"Watson, Tom",1,Anfield
1914-02-14,1913,Bolton Wanderers,Liverpool,2-1,2,1,1,1,3,1,H,"Watson, Tom",1,Away
1914-02-28,1913,Oldham Athletic,Liverpool,2-2,2,2,1,1,4,0,D,"Watson, Tom",2,Away
1914-03-14,1913,Burnley,Liverpool,5-2,5,2,1,1,7,3,H,"Watson, Tom",2,Away
1914-03-18,1913,Liverpool,Chelsea,3-0,3,0,1,1,3,3,H,"Watson, Tom",3,Anfield
1914-03-21,1913,Liverpool,Preston North End,3-1,3,1,1,1,4,2,H,"Watson, Tom",3,Anfield
1914-04-01,1913,Newcastle United,Liverpool,1-2,1,2,1,1,3,-1,A,"Watson, Tom",2,Away
1914-04-04,1913,Tottenham Hotspur,Liverpool,0-0,0,0,1,1,0,0,D,"Watson, Tom",0,Away
1914-04-10,1913,Liverpool,Derby County,1-0,1,0,1,1,1,1,H,"Watson, Tom",1,Anfield
1914-04-11,1913,Liverpool,Aston Villa,0-1,0,1,1,1,1,-1,A,"Watson, Tom",0,Anfield
1914-04-13,1913,Bradford City,Liverpool,1-0,1,0,1,1,1,1,H,"Watson, Tom",0,Away
1914-04-15,1913,Liverpool,Manchester United,1-2,1,2,1,1,3,-1,A,"Watson, Tom",1,Anfield
1914-04-18,1913,Middlesbrough,Liverpool,4-0,4,0,1,1,4,4,H,"Watson, Tom",0,Away
1914-04-27,1913,Liverpool,Sheffield United,2-1,2,1,1,1,3,1,H,"Watson, Tom",2,Anfield
1914-09-02,1914,Liverpool,Bolton Wanderers,4-3,4,3,1,1,7,1,H,"Watson, Tom",4,Anfield
1914-09-05,1914,Liverpool,Notts County,1-1,1,1,1,1,2,0,D,"Watson, Tom",1,Anfield
1914-09-12,1914,Sunderland,Liverpool,2-2,2,2,1,1,4,0,D,"Watson, Tom",2,Away
1914-09-19,1914,Liverpool,Sheffield Wednesday,2-1,2,1,1,1,3,1,H,"Watson, Tom",2,Anfield
1914-09-21,1914,Blackburn Rovers,Liverpool,4-2,4,2,1,1,6,2,H,"Watson, Tom",2,Away
1914-09-26,1914,West Bromwich Albion,Liverpool,4-0,4,0,1,1,4,4,H,"Watson, Tom",0,Away
1914-10-03,1914,Liverpool,Everton,0-5,0,5,1,1,5,-5,A,"Watson, Tom",0,Anfield
1914-10-10,1914,Chelsea,Liverpool,3-1,3,1,1,1,4,2,H,"Watson, Tom",1,Away
1914-10-17,1914,Liverpool,Bradford City,2-1,2,1,1,1,3,1,H,"Watson, Tom",2,Anfield
1914-10-24,1914,Burnley,Liverpool,3-0,3,0,1,1,3,3,H,"Watson, Tom",0,Away
1914-10-31,1914,Liverpool,Tottenham Hotspur,7-2,7,2,1,1,9,5,H,"Watson, Tom",7,Anfield
1914-11-07,1914,Newcastle United,Liverpool,0-0,0,0,1,1,0,0,D,"Watson, Tom",0,Away
1914-11-14,1914,Liverpool,Middlesbrough,1-1,1,1,1,1,2,0,D,"Watson, Tom",1,Anfield
1914-11-21,1914,Sheffield United,Liverpool,2-1,2,1,1,1,3,1,H,"Watson, Tom",1,Away
1914-11-28,1914,Liverpool,Aston Villa,3-6,3,6,1,1,9,-3,A,"Watson, Tom",3,Anfield
1914-12-05,1914,Manchester City,Liverpool,1-1,1,1,1,1,2,0,D,"Watson, Tom",1,Away
1914-12-12,1914,Bradford Park Avenue,Liverpool,1-0,1,0,1,1,1,1,H,"Watson, Tom",0,Away
1914-12-19,1914,Liverpool,Oldham Athletic,1-2,1,2,1,1,3,-1,A,"Watson, Tom",1,Anfield
1914-12-25,1914,Bolton Wanderers,Liverpool,0-1,0,1,1,1,1,-1,A,"Watson, Tom",1,Away
1914-12-26,1914,Liverpool,Manchester United,1-1,1,1,1,1,2,0,D,"Watson, Tom",1,Anfield
1915-01-02,1914,Notts County,Liverpool,3-1,3,1,1,1,4,2,H,"Watson, Tom",1,Away
1915-01-16,1914,Liverpool,Sunderland,2-1,2,1,1,1,3,1,H,"Watson, Tom",2,Anfield
1915-01-23,1914,Sheffield Wednesday,Liverpool,2-1,2,1,1,1,3,1,H,"Watson, Tom",1,Away
1915-02-06,1914,Everton,Liverpool,1-3,1,3,1,1,4,-2,A,"Watson, Tom",3,Away
1915-02-13,1914,Liverpool,Chelsea,3-3,3,3,1,1,6,0,D,"Watson, Tom",3,Anfield
1915-02-27,1914,Liverpool,Burnley,3-0,3,0,1,1,3,3,H,"Watson, Tom",3,Anfield
1915-03-06,1914,Tottenham Hotspur,Liverpool,1-1,1,1,1,1,2,0,D,"Watson, Tom",1,Away
1915-03-10,1914,Bradford City,Liverpool,3-2,3,2,1,1,5,1,H,"Watson, Tom",2,Away
1915-03-13,1914,Liverpool,Manchester City,3-2,3,2,1,1,5,1,H,"Watson, Tom",3,Anfield
1915-03-20,1914,Middlesbrough,Liverpool,3-0,3,0,1,1,3,3,H,"Watson, Tom",0,Away
1915-03-24,1914,Liverpool,West Bromwich Albion,3-1,3,1,1,1,4,2,H,"Watson, Tom",3,Anfield
1915-03-29,1914,Liverpool,Newcastle United,2-2,2,2,1,1,4,0,D,"Watson, Tom",2,Anfield
1915-04-02,1914,Manchester United,Liverpool,2-0,2,0,1,1,2,2,H,"Watson, Tom",0,Away
1915-04-03,1914,Aston Villa,Liverpool,6-2,6,2,1,1,8,4,H,"Watson, Tom",2,Away
1915-04-05,1914,Liverpool,Blackburn Rovers,3-0,3,0,1,1,3,3,H,"Watson, Tom",3,Anfield
1915-04-12,1914,Liverpool,Sheffield United,2-1,2,1,1,1,3,1,H,"Watson, Tom",2,Anfield
1915-04-17,1914,Liverpool,Bradford Park Avenue,2-1,2,1,1,1,3,1,H,"Watson, Tom",2,Anfield
1915-04-24,1914,Oldham Athletic,Liverpool,0-2,0,2,1,1,2,-2,A,"Watson, Tom",2,Away
1919-08-30,1919,Bradford City,Liverpool,1-3,1,3,1,1,4,-2,A,"Patterson, George",3,Away
1919-09-01,1919,Liverpool,Arsenal,2-3,2,3,1,1,5,-1,A,"Patterson, George",2,Anfield
1919-09-06,1919,Liverpool,Bradford City,2-1,2,1,1,1,3,1,H,"Patterson, George",2,Anfield
1919-09-08,1919,Arsenal,Liverpool,1-0,1,0,1,1,1,1,H,"Patterson, George",0,Away
1919-09-13,1919,Liverpool,Aston Villa,2-1,2,1,1,1,3,1,H,"Patterson, George",2,Anfield
1919-09-20,1919,Aston Villa,Liverpool,0-1,0,1,1,1,1,-1,A,"Patterson, George",1,Away
1919-09-27,1919,Liverpool,Newcastle United,1-1,1,1,1,1,2,0,D,"Patterson, George",1,Anfield
1919-10-04,1919,Newcastle United,Liverpool,3-0,3,0,1,1,3,3,H,"Patterson, George",0,Away
1919-10-11,1919,Chelsea,Liverpool,1-0,1,0,1,1,1,1,H,"Patterson, George",0,Away
1919-10-18,1919,Liverpool,Chelsea,0-1,0,1,1,1,1,-1,A,"Patterson, George",0,Anfield
1919-10-25,1919,Burnley,Liverpool,1-2,1,2,1,1,3,-1,A,"Patterson, George",2,Away
1919-11-01,1919,Liverpool,Burnley,0-1,0,1,1,1,1,-1,A,"Patterson, George",0,Anfield
1919-11-08,1919,Bradford Park Avenue,Liverpool,1-2,1,2,1,1,3,-1,A,"Patterson, George",2,Away
1919-11-15,1919,Liverpool,Bradford Park Avenue,3-3,3,3,1,1,6,0,D,"Patterson, George",3,Anfield
1919-11-22,1919,Preston North End,Liverpool,2-1,2,1,1,1,3,1,H,"Patterson, George",1,Away
1919-11-29,1919,Liverpool,Preston North End,1-2,1,2,1,1,3,-1,A,"Patterson, George",1,Anfield
1919-12-06,1919,Middlesbrough,Liverpool,3-2,3,2,1,1,5,1,H,"Patterson, George",2,Away
1919-12-13,1919,Liverpool,Middlesbrough,1-0,1,0,1,1,1,1,H,"Patterson, George",1,Anfield
1919-12-20,1919,Everton,Liverpool,0-0,0,0,1,1,0,0,D,"Ashworth, David",0,Away
1919-12-25,1919,Liverpool,Sunderland,3-2,3,2,1,1,5,1,H,"Ashworth, David",3,Anfield
1919-12-26,1919,Manchester United,Liverpool,0-0,0,0,1,1,0,0,D,"Ashworth, David",0,Away
1919-12-27,1919,Liverpool,Everton,3-1,3,1,1,1,4,2,H,"Ashworth, David",3,Anfield
1920-01-01,1919,Liverpool,Manchester United,0-0,0,0,1,1,0,0,D,"Ashworth, David",0,Anfield
1920-01-03,1919,Sheffield United,Liverpool,3-2,3,2,1,1,5,1,H,"Ashworth, David",2,Away
1920-01-17,1919,Liverpool,Sheffield United,2-0,2,0,1,1,2,2,H,"Ashworth, David",2,Anfield
1920-01-24,1919,Bolton Wanderers,Liverpool,0-3,0,3,1,1,3,-3,A,"Ashworth, David",3,Away
1920-02-04,1919,Liverpool,Bolton Wanderers,2-0,2,0,1,1,2,2,H,"Ashworth, David",2,Anfield
1920-02-07,1919,Blackburn Rovers,Liverpool,0-2,0,2,1,1,2,-2,A,"Ashworth, David",2,Away
1920-02-14,1919,Liverpool,Blackburn Rovers,3-0,3,0,1,1,3,3,H,"Ashworth, David",3,Anfield
1920-02-26,1919,Notts County,Liverpool,1-0,1,0,1,1,1,1,H,"Ashworth, David",0,Away
1920-02-28,1919,Liverpool,Notts County,3-0,3,0,1,1,3,3,H,"Ashworth, David",3,Anfield
1920-03-10,1919,Liverpool,Sheffield Wednesday,1-0,1,0,1,1,1,1,H,"Ashworth, David",1,Anfield
1920-03-13,1919,Sheffield Wednesday,Liverpool,2-2,2,2,1,1,4,0,D,"Ashworth, David",2,Away
1920-03-20,1919,Liverpool,Manchester City,1-0,1,0,1,1,1,1,H,"Ashworth, David",1,Anfield
1920-03-27,1919,Manchester City,Liverpool,2-1,2,1,1,1,3,1,H,"Ashworth, David",1,Away
1920-04-02,1919,Oldham Athletic,Liverpool,1-1,1,1,1,1,2,0,D,"Ashworth, David",1,Away
1920-04-03,1919,Liverpool,Derby County,3-0,3,0,1,1,3,3,H,"Ashworth, David",3,Anfield
1920-04-05,1919,Liverpool,Oldham Athletic,2-2,2,2,1,1,4,0,D,"Ashworth, David",2,Anfield
1920-04-10,1919,Derby County,Liverpool,3-0,3,0,1,1,3,3,H,"Ashworth, David",0,Away
1920-04-17,1919,Liverpool,West Bromwich Albion,0-0,0,0,1,1,0,0,D,"Ashworth, David",0,Anfield
1920-04-24,1919,West Bromwich Albion,Liverpool,1-1,1,1,1,1,2,0,D,"Ashworth, David",1,Away
1920-05-01,1919,Sunderland,Liverpool,0-1,0,1,1,1,1,-1,A,"Ashworth, David",1,Away
1920-08-28,1920,Liverpool,Manchester City,4-2,4,2,1,1,6,2,H,"Ashworth, David",4,Anfield
1920-09-01,1920,West Bromwich Albion,Liverpool,1-1,1,1,1,1,2,0,D,"Ashworth, David",1,Away
1920-09-04,1920,Manchester City,Liverpool,3-2,3,2,1,1,5,1,H,"Ashworth, David",2,Away
1920-09-06,1920,Liverpool,West Bromwich Albion,0-0,0,0,1,1,0,0,D,"Ashworth, David",0,Anfield
1920-09-11,1920,Liverpool,Oldham Athletic,5-2,5,2,1,1,7,3,H,"Ashworth, David",5,Anfield
1920-09-18,1920,Oldham Athletic,Liverpool,0-0,0,0,1,1,0,0,D,"Ashworth, David",0,Away
1920-09-25,1920,Liverpool,Preston North End,6-0,6,0,1,1,6,6,H,"Ashworth, David",6,Anfield
1920-10-02,1920,Preston North End,Liverpool,2-3,2,3,1,1,5,-1,A,"Ashworth, David",3,Away
1920-10-09,1920,Liverpool,Sheffield United,2-2,2,2,1,1,4,0,D,"Ashworth, David",2,Anfield
1920-10-16,1920,Sheffield United,Liverpool,0-1,0,1,1,1,1,-1,A,"Ashworth, David",1,Away
1920-10-23,1920,Liverpool,Everton,1-0,1,0,1,1,1,1,H,"Ashworth, David",1,Anfield
1920-10-30,1920,Everton,Liverpool,0-3,0,3,1,1,3,-3,A,"Ashworth, David",3,Away
1920-11-06,1920,Liverpool,Bradford Park Avenue,0-1,0,1,1,1,1,-1,A,"Ashworth, David",0,Anfield
1920-11-13,1920,Bradford Park Avenue,Liverpool,1-3,1,3,1,1,4,-2,A,"Ashworth, David",3,Away
1920-11-20,1920,Newcastle United,Liverpool,2-0,2,0,1,1,2,2,H,"Ashworth, David",0,Away
1920-11-27,1920,Liverpool,Newcastle United,0-1,0,1,1,1,1,-1,A,"Ashworth, David",0,Anfield
1920-12-04,1920,Liverpool,Burnley,0-0,0,0,1,1,0,0,D,"Ashworth, David",0,Anfield
1920-12-11,1920,Burnley,Liverpool,1-0,1,0,1,1,1,1,H,"Ashworth, David",0,Away
1920-12-18,1920,Liverpool,Aston Villa,4-1,4,1,1,1,5,3,H,"Ashworth, David",4,Anfield
1920-12-25,1920,Chelsea,Liverpool,1-1,1,1,1,1,2,0,D,"Ashworth, David",1,Away
1920-12-27,1920,Liverpool,Chelsea,2-1,2,1,1,1,3,1,H,"Ashworth, David",2,Anfield
1921-01-01,1920,Aston Villa,Liverpool,0-2,0,2,1,1,2,-2,A,"Ashworth, David",2,Away
1921-01-15,1920,Liverpool,Sunderland,0-0,0,0,1,1,0,0,D,"Ashworth, David",0,Anfield
1921-01-22,1920,Sunderland,Liverpool,2-1,2,1,1,1,3,1,H,"Ashworth, David",1,Away
1921-02-05,1920,Manchester United,Liverpool,1-1,1,1,1,1,2,0,D,"Ashworth, David",1,Away
1921-02-09,1920,Liverpool,Manchester United,2-0,2,0,1,1,2,2,H,"Ashworth, David",2,Anfield
1921-02-12,1920,Liverpool,Bradford City,2-1,2,1,1,1,3,1,H,"Ashworth, David",2,Anfield
1921-02-19,1920,Bradford City,Liverpool,0-0,0,0,1,1,0,0,D,"Ashworth, David",0,Away
1921-02-26,1920,Liverpool,Huddersfield Town,4-1,4,1,1,1,5,3,H,"Ashworth, David",4,Anfield
1921-03-05,1920,Huddersfield Town,Liverpool,1-2,1,2,1,1,3,-1,A,"Ashworth, David",2,Away
1921-03-12,1920,Liverpool,Middlesbrough,0-0,0,0,1,1,0,0,D,"Ashworth, David",0,Anfield
1921-03-19,1920,Middlesbrough,Liverpool,0-1,0,1,1,1,1,-1,A,"Ashworth, David",1,Away
1921-03-25,1920,Liverpool,Tottenham Hotspur,1-1,1,1,1,1,2,0,D,"Ashworth, David",1,Anfield
1921-03-26,1920,Blackburn Rovers,Liverpool,1-1,1,1,1,1,2,0,D,"Ashworth, David",1,Away
1921-03-28,1920,Tottenham Hotspur,Liverpool,1-0,1,0,1,1,1,1,H,"Ashworth, David",0,Away
1921-04-02,1920,Liverpool,Blackburn Rovers,2-0,2,0,1,1,2,2,H,"Ashworth, David",2,Anfield
1921-04-09,1920,Derby County,Liverpool,0-0,0,0,1,1,0,0,D,"Ashworth, David",0,Away
1921-04-16,1920,Liverpool,Derby County,1-1,1,1,1,1,2,0,D,"Ashworth, David",1,Anfield
1921-04-23,1920,Bolton Wanderers,Liverpool,1-0,1,0,1,1,1,1,H,"Ashworth, David",0,Away
1921-04-30,1920,Liverpool,Bolton Wanderers,2-3,2,3,1,1,5,-1,A,"Ashworth, David",2,Anfield
1921-05-02,1920,Arsenal,Liverpool,0-0,0,0,1,1,0,0,D,"Ashworth, David",0,Away
1921-05-07,1920,Liverpool,Arsenal,3-0,3,0,1,1,3,3,H,"Ashworth, David",3,Anfield
1921-08-27,1921,Sunderland,Liverpool,3-0,3,0,1,1,3,3,H,"Ashworth, David",0,Away
1921-08-31,1921,Liverpool,Manchester City,3-2,3,2,1,1,5,1,H,"Ashworth, David",3,Anfield
1921-09-03,1921,Liverpool,Sunderland,2-1,2,1,1,1,3,1,H,"Ashworth, David",2,Anfield
1921-09-07,1921,Manchester City,Liverpool,1-1,1,1,1,1,2,0,D,"Ashworth, David",1,Away
1921-09-10,1921,Sheffield United,Liverpool,0-1,0,1,1,1,1,-1,A,"Ashworth, David",1,Away
1921-09-17,1921,Liverpool,Sheffield United,1-1,1,1,1,1,2,0,D,"Ashworth, David",1,Anfield
1921-09-24,1921,Chelsea,Liverpool,0-1,0,1,1,1,1,-1,A,"Ashworth, David",1,Away
1921-10-01,1921,Liverpool,Chelsea,1-1,1,1,1,1,2,0,D,"Ashworth, David",1,Anfield
1921-10-08,1921,Preston North End,Liverpool,1-1,1,1,1,1,2,0,D,"Ashworth, David",1,Away
1921-10-15,1921,Liverpool,Preston North End,4-0,4,0,1,1,4,4,H,"Ashworth, David",4,Anfield
1921-10-22,1921,Tottenham Hotspur,Liverpool,0-1,0,1,1,1,1,-1,A,"Ashworth, David",1,Away
1921-10-29,1921,Liverpool,Tottenham Hotspur,1-1,1,1,1,1,2,0,D,"Ashworth, David",1,Anfield
1921-11-05,1921,Everton,Liverpool,1-1,1,1,1,1,2,0,D,"Ashworth, David",1,Away
1921-11-12,1921,Liverpool,Everton,1-1,1,1,1,1,2,0,D,"Ashworth, David",1,Anfield
1921-11-19,1921,Liverpool,Middlesbrough,4-0,4,0,1,1,4,4,H,"Ashworth, David",4,Anfield
1921-11-26,1921,Middlesbrough,Liverpool,3-1,3,1,1,1,4,2,H,"Ashworth, David",1,Away
1921-12-03,1921,Aston Villa,Liverpool,1-1,1,1,1,1,2,0,D,"Ashworth, David",1,Away
1921-12-10,1921,Liverpool,Aston Villa,2-0,2,0,1,1,2,2,H,"Ashworth, David",2,Anfield
1921-12-17,1921,Liverpool,Manchester United,2-1,2,1,1,1,3,1,H,"Ashworth, David",2,Anfield
1921-12-24,1921,Manchester United,Liverpool,0-0,0,0,1,1,0,0,D,"Ashworth, David",0,Away
1921-12-26,1921,Liverpool,Newcastle United,1-0,1,0,1,1,1,1,H,"Ashworth, David",1,Anfield
1921-12-27,1921,Liverpool,Huddersfield Town,2-0,2,0,1,1,2,2,H,"Ashworth, David",2,Anfield
1921-12-31,1921,Bradford City,Liverpool,0-0,0,0,1,1,0,0,D,"Ashworth, David",0,Away
1922-01-02,1921,Newcastle United,Liverpool,1-1,1,1,1,1,2,0,D,"Ashworth, David",1,Away
1922-01-14,1921,Liverpool,Bradford City,2-1,2,1,1,1,3,1,H,"Ashworth, David",2,Anfield
1922-01-21,1921,Huddersfield Town,Liverpool,0-1,0,1,1,1,1,-1,A,"Ashworth, David",1,Away
1922-02-04,1921,Birmingham City,Liverpool,0-2,0,2,1,1,2,-2,A,"Ashworth, David",2,Away
1922-02-11,1921,Liverpool,Birmingham City,1-0,1,0,1,1,1,1,H,"Ashworth, David",1,Anfield
1922-02-25,1921,Liverpool,Arsenal,4-0,4,0,1,1,4,4,H,"Ashworth, David",4,Anfield
1922-03-04,1921,Blackburn Rovers,Liverpool,0-0,0,0,1,1,0,0,D,"Ashworth, David",0,Away
1922-03-11,1921,Liverpool,Blackburn Rovers,2-0,2,0,1,1,2,2,H,"Ashworth, David",2,Anfield
1922-03-18,1921,Liverpool,Bolton Wanderers,0-2,0,2,1,1,2,-2,A,"Ashworth, David",0,Anfield
1922-03-22,1921,Arsenal,Liverpool,1-0,1,0,1,1,1,1,H,"Ashworth, David",0,Away
1922-03-25,1921,Bolton Wanderers,Liverpool,1-3,1,3,1,1,4,-2,A,"Ashworth, David",3,Away
1922-04-01,1921,Liverpool,Oldham Athletic,2-0,2,0,1,1,2,2,H,"Ashworth, David",2,Anfield
1922-04-08,1921,Oldham Athletic,Liverpool,4-0,4,0,1,1,4,4,H,"Ashworth, David",0,Away
1922-04-14,1921,Burnley,Liverpool,1-1,1,1,1,1,2,0,D,"Ashworth, David",1,Away
1922-04-15,1921,Liverpool,Cardiff City,5-1,5,1,1,1,6,4,H,"Ashworth, David",5,Anfield
1922-04-17,1921,Liverpool,Burnley,2-1,2,1,1,1,3,1,H,"Ashworth, David",2,Anfield
1922-04-22,1921,Cardiff City,Liverpool,2-0,2,0,1,1,2,2,H,"Ashworth, David",0,Away
1922-04-29,1921,Liverpool,West Bromwich Albion,1-2,1,2,1,1,3,-1,A,"Ashworth, David",1,Anfield
1922-05-06,1921,West Bromwich Albion,Liverpool,1-4,1,4,1,1,5,-3,A,"Ashworth, David",4,Away
1922-08-26,1922,Liverpool,Arsenal,5-2,5,2,1,1,7,3,H,"Ashworth, David",5,Anfield
1922-08-30,1922,Sunderland,Liverpool,1-0,1,0,1,1,1,1,H,"Ashworth, David",0,Away
1922-09-02,1922,Arsenal,Liverpool,1-0,1,0,1,1,1,1,H,"Ashworth, David",0,Away
1922-09-06,1922,Liverpool,Sunderland,5-1,5,1,1,1,6,4,H,"Ashworth, David",5,Anfield
1922-09-09,1922,Preston North End,Liverpool,1-3,1,3,1,1,4,-2,A,"Ashworth, David",3,Away
1922-09-16,1922,Liverpool,Preston North End,5-2,5,2,1,1,7,3,H,"Ashworth, David",5,Anfield
1922-09-23,1922,Liverpool,Burnley,3-0,3,0,1,1,3,3,H,"Ashworth, David",3,Anfield
1922-09-30,1922,Burnley,Liverpool,2-0,2,0,1,1,2,2,H,"Ashworth, David",0,Away
1922-10-07,1922,Liverpool,Everton,5-1,5,1,1,1,6,4,H,"Ashworth, David",5,Anfield
1922-10-14,1922,Everton,Liverpool,0-1,0,1,1,1,1,-1,A,"Ashworth, David",1,Away
1922-10-21,1922,Liverpool,Cardiff City,3-1,3,1,1,1,4,2,H,"Ashworth, David",3,Anfield
1922-10-28,1922,Cardiff City,Liverpool,3-0,3,0,1,1,3,3,H,"Ashworth, David",0,Away
1922-11-04,1922,Tottenham Hotspur,Liverpool,2-4,2,4,1,1,6,-2,A,"Ashworth, David",4,Away
1922-11-11,1922,Liverpool,Tottenham Hotspur,0-0,0,0,1,1,0,0,D,"Ashworth, David",0,Anfield
1922-11-18,1922,Liverpool,Aston Villa,3-0,3,0,1,1,3,3,H,"Ashworth, David",3,Anfield
1922-11-25,1922,Aston Villa,Liverpool,0-1,0,1,1,1,1,-1,A,"Ashworth, David",1,Away
1922-12-02,1922,Liverpool,Newcastle United,0-2,0,2,1,1,2,-2,A,"Ashworth, David",0,Anfield
1922-12-09,1922,Newcastle United,Liverpool,0-1,0,1,1,1,1,-1,A,"Ashworth, David",1,Away
1922-12-16,1922,Liverpool,Nottingham Forest,2-1,2,1,1,1,3,1,H,"Ashworth, David",2,Anfield
1922-12-23,1922,Nottingham Forest,Liverpool,1-3,1,3,1,1,4,-2,A,"Ashworth, David",3,Away
1922-12-25,1922,Oldham Athletic,Liverpool,0-2,0,2,1,1,2,-2,A,"Ashworth, David",2,Away
1922-12-26,1922,Liverpool,Oldham Athletic,2-1,2,1,1,1,3,1,H,"Ashworth, David",2,Anfield
1922-12-30,1922,Chelsea,Liverpool,0-0,0,0,1,1,0,0,D,"Ashworth, David",0,Away
1923-01-06,1922,Liverpool,Chelsea,1-0,1,0,1,1,1,1,H,"Ashworth, David",1,Anfield
1923-01-20,1922,Middlesbrough,Liverpool,0-2,0,2,1,1,2,-2,A,"Ashworth, David",2,Away
1923-01-27,1922,Liverpool,Middlesbrough,2-0,2,0,1,1,2,2,H,"Ashworth, David",2,Anfield
1923-02-07,1922,Liverpool,West Bromwich Albion,2-0,2,0,1,1,2,2,H,"Ashworth, David",2,Anfield
1923-02-10,1922,West Bromwich Albion,Liverpool,0-0,0,0,1,1,0,0,D,"Ashworth, David",0,Away
1923-02-17,1922,Liverpool,Blackburn Rovers,3-0,3,0,1,1,3,3,H,"McQueen, Matt",3,Anfield
1923-03-03,1922,Liverpool,Bolton Wanderers,3-0,3,0,1,1,3,3,H,"McQueen, Matt",3,Anfield
1923-03-12,1922,Blackburn Rovers,Liverpool,1-0,1,0,1,1,1,1,H,"McQueen, Matt",0,Away
1923-03-17,1922,Manchester City,Liverpool,1-0,1,0,1,1,1,1,H,"McQueen, Matt",0,Away
1923-03-24,1922,Liverpool,Manchester City,2-0,2,0,1,1,2,2,H,"McQueen, Matt",2,Anfield
1923-03-30,1922,Liverpool,Sheffield United,2-1,2,1,1,1,3,1,H,"McQueen, Matt",2,Anfield
1923-03-31,1922,Birmingham City,Liverpool,0-1,0,1,1,1,1,-1,A,"McQueen, Matt",1,Away
1923-04-02,1922,Sheffield United,Liverpool,4-1,4,1,1,1,5,3,H,"McQueen, Matt",1,Away
1923-04-07,1922,Liverpool,Birmingham City,0-0,0,0,1,1,0,0,D,"McQueen, Matt",0,Anfield
1923-04-14,1922,Huddersfield Town,Liverpool,0-0,0,0,1,1,0,0,D,"McQueen, Matt",0,Away
1923-04-18,1922,Bolton Wanderers,Liverpool,1-1,1,1,1,1,2,0,D,"McQueen, Matt",1,Away
1923-04-21,1922,Liverpool,Huddersfield Town,1-1,1,1,1,1,2,0,D,"McQueen, Matt",1,Anfield
1923-04-28,1922,Stoke City,Liverpool,0-0,0,0,1,1,0,0,D,"McQueen, Matt",0,Away
1923-05-05,1922,Liverpool,Stoke City,1-0,1,0,1,1,1,1,H,"McQueen, Matt",1,Anfield
1923-08-25,1923,West Bromwich Albion,Liverpool,2-0,2,0,1,1,2,2,H,"McQueen, Matt",0,Away
1923-08-29,1923,Liverpool,Birmingham City,6-2,6,2,1,1,8,4,H,"McQueen, Matt",6,Anfield
1923-09-01,1923,Liverpool,West Bromwich Albion,0-0,0,0,1,1,0,0,D,"McQueen, Matt",0,Anfield
1923-09-05,1923,Birmingham City,Liverpool,2-1,2,1,1,1,3,1,H,"McQueen, Matt",1,Away
1923-09-08,1923,Preston North End,Liverpool,0-1,0,1,1,1,1,-1,A,"McQueen, Matt",1,Away
1923-09-15,1923,Liverpool,Preston North End,3-1,3,1,1,1,4,2,H,"McQueen, Matt",3,Anfield
1923-09-22,1923,Burnley,Liverpool,2-0,2,0,1,1,2,2,H,"McQueen, Matt",0,Away
1923-09-29,1923,Liverpool,Burnley,1-0,1,0,1,1,1,1,H,"McQueen, Matt",1,Anfield
1923-10-06,1923,Everton,Liverpool,1-0,1,0,1,1,1,1,H,"McQueen, Matt",0,Away
1923-10-13,1923,Liverpool,Everton,1-2,1,2,1,1,3,-1,A,"McQueen, Matt",1,Anfield
1923-10-20,1923,Liverpool,Nottingham Forest,4-2,4,2,1,1,6,2,H,"McQueen, Matt",4,Anfield
1923-10-27,1923,Nottingham Forest,Liverpool,0-1,0,1,1,1,1,-1,A,"McQueen, Matt",1,Away
1923-11-03,1923,Liverpool,Huddersfield Town,1-1,1,1,1,1,2,0,D,"McQueen, Matt",1,Anfield
1923-11-10,1923,Huddersfield Town,Liverpool,3-1,3,1,1,1,4,2,H,"McQueen, Matt",1,Away
1923-11-17,1923,Aston Villa,Liverpool,0-0,0,0,1,1,0,0,D,"McQueen, Matt",0,Away
1923-11-24,1923,Liverpool,Aston Villa,0-1,0,1,1,1,1,-1,A,"McQueen, Matt",0,Anfield
1923-12-01,1923,Sheffield United,Liverpool,1-1,1,1,1,1,2,0,D,"McQueen, Matt",1,Away
1923-12-08,1923,Liverpool,Sheffield United,2-3,2,3,1,1,5,-1,A,"McQueen, Matt",2,Anfield
1923-12-15,1923,Liverpool,Cardiff City,0-2,0,2,1,1,2,-2,A,"McQueen, Matt",0,Anfield
1923-12-22,1923,Cardiff City,Liverpool,2-0,2,0,1,1,2,2,H,"McQueen, Matt",0,Away
1923-12-25,1923,Liverpool,Newcastle United,0-1,0,1,1,1,1,-1,A,"McQueen, Matt",0,Anfield
1923-12-26,1923,Newcastle United,Liverpool,2-1,2,1,1,1,3,1,H,"McQueen, Matt",1,Away
1923-12-29,1923,Liverpool,West Ham United,2-0,2,0,1,1,2,2,H,"McQueen, Matt",2,Anfield
1924-01-01,1923,Liverpool,Chelsea,3-1,3,1,1,1,4,2,H,"McQueen, Matt",3,Anfield
1924-01-05,1923,West Ham United,Liverpool,1-0,1,0,1,1,1,1,H,"McQueen, Matt",0,Away
1924-01-19,1923,Manchester City,Liverpool,0-1,0,1,1,1,1,-1,A,"McQueen, Matt",1,Away
1924-01-26,1923,Liverpool,Manchester City,0-0,0,0,1,1,0,0,D,"McQueen, Matt",0,Anfield
1924-02-09,1923,Liverpool,Bolton Wanderers,3-1,3,1,1,1,4,2,H,"McQueen, Matt",3,Anfield
1924-02-16,1923,Sunderland,Liverpool,0-0,0,0,1,1,0,0,D,"McQueen, Matt",0,Away
1924-03-01,1923,Arsenal,Liverpool,3-1,3,1,1,1,4,2,H,"McQueen, Matt",1,Away
1924-03-12,1923,Bolton Wanderers,Liverpool,4-1,4,1,1,1,5,3,H,"McQueen, Matt",1,Away
1924-03-15,1923,Liverpool,Blackburn Rovers,0-0,0,0,1,1,0,0,D,"McQueen, Matt",0,Anfield
1924-03-19,1923,Liverpool,Sunderland,4-2,4,2,1,1,6,2,H,"McQueen, Matt",4,Anfield
1924-03-22,1923,Blackburn Rovers,Liverpool,0-0,0,0,1,1,0,0,D,"McQueen, Matt",0,Away
1924-03-29,1923,Liverpool,Tottenham Hotspur,1-0,1,0,1,1,1,1,H,"McQueen, Matt",1,Anfield
1924-04-02,1923,Liverpool,Arsenal,0-0,0,0,1,1,0,0,D,"McQueen, Matt",0,Anfield
1924-04-05,1923,Tottenham Hotspur,Liverpool,1-1,1,1,1,1,2,0,D,"McQueen, Matt",1,Away
1924-04-12,1923,Liverpool,Middlesbrough,3-1,3,1,1,1,4,2,H,"McQueen, Matt",3,Anfield
1924-04-18,1923,Chelsea,Liverpool,2-1,2,1,1,1,3,1,H,"McQueen, Matt",1,Away
1924-04-19,1923,Middlesbrough,Liverpool,1-1,1,1,1,1,2,0,D,"McQueen, Matt",1,Away
1924-04-26,1923,Liverpool,Notts County,1-0,1,0,1,1,1,1,H,"McQueen, Matt",1,Anfield
1924-05-03,1923,Notts County,Liverpool,1-2,1,2,1,1,3,-1,A,"McQueen, Matt",2,Away
1924-08-30,1924,Liverpool,Aston Villa,2-4,2,4,1,1,6,-2,A,"McQueen, Matt",2,Anfield
1924-09-06,1924,Arsenal,Liverpool,2-0,2,0,1,1,2,2,H,"McQueen, Matt",0,Away
1924-09-13,1924,Liverpool,Manchester City,5-3,5,3,1,1,8,2,H,"McQueen, Matt",5,Anfield
1924-09-15,1924,Blackburn Rovers,Liverpool,3-1,3,1,1,1,4,2,H,"McQueen, Matt",1,Away
1924-09-20,1924,Bury,Liverpool,0-0,0,0,1,1,0,0,D,"McQueen, Matt",0,Away
1924-09-27,1924,Liverpool,Nottingham Forest,3-0,3,0,1,1,3,3,H,"McQueen, Matt",3,Anfield
1924-10-04,1924,Everton,Liverpool,0-1,0,1,1,1,1,-1,A,"McQueen, Matt",1,Away
1924-10-11,1924,Newcastle United,Liverpool,0-0,0,0,1,1,0,0,D,"McQueen, Matt",0,Away
1924-10-15,1924,Liverpool,Blackburn Rovers,0-0,0,0,1,1,0,0,D,"McQueen, Matt",0,Anfield
1924-10-18,1924,Liverpool,Sheffield United,4-1,4,1,1,1,5,3,H,"McQueen, Matt",4,Anfield
1924-10-25,1924,Liverpool,Sunderland,3-1,3,1,1,1,4,2,H,"McQueen, Matt",3,Anfield
1924-11-08,1924,Liverpool,Preston North End,3-1,3,1,1,1,4,2,H,"McQueen, Matt",3,Anfield
1924-11-12,1924,Liverpool,Huddersfield Town,2-3,2,3,1,1,5,-1,A,"McQueen, Matt",2,Anfield
1924-11-15,1924,Burnley,Liverpool,2-1,2,1,1,1,3,1,H,"McQueen, Matt",1,Away
1924-11-22,1924,Liverpool,Leeds United,1-0,1,0,1,1,1,1,H,"McQueen, Matt",1,Anfield
1924-11-29,1924,Birmingham City,Liverpool,5-2,5,2,1,1,7,3,H,"McQueen, Matt",2,Away
1924-12-06,1924,Liverpool,West Bromwich Albion,1-1,1,1,1,1,2,0,D,"McQueen, Matt",1,Anfield
1924-12-13,1924,Tottenham Hotspur,Liverpool,1-1,1,1,1,1,2,0,D,"McQueen, Matt",1,Away
1924-12-15,1924,Cardiff City,Liverpool,1-3,1,3,1,1,4,-2,A,"McQueen, Matt",3,Away
1924-12-20,1924,Liverpool,Bolton Wanderers,0-0,0,0,1,1,0,0,D,"McQueen, Matt",0,Anfield
1924-12-25,1924,Notts County,Liverpool,1-2,1,2,1,1,3,-1,A,"McQueen, Matt",2,Away
1924-12-26,1924,Liverpool,Notts County,1-0,1,0,1,1,1,1,H,"McQueen, Matt",1,Anfield
1925-01-03,1924,Liverpool,Arsenal,2-1,2,1,1,1,3,1,H,"McQueen, Matt",2,Anfield
1925-01-17,1924,Manchester City,Liverpool,5-0,5,0,1,1,5,5,H,"McQueen, Matt",0,Away
1925-01-21,1924,Aston Villa,Liverpool,1-4,1,4,1,1,5,-3,A,"McQueen, Matt",4,Away
1925-01-24,1924,Liverpool,Bury,4-0,4,0,1,1,4,4,H,"McQueen, Matt",4,Anfield
1925-02-04,1924,Nottingham Forest,Liverpool,0-1,0,1,1,1,1,-1,A,"McQueen, Matt",1,Away
1925-02-07,1924,Liverpool,Everton,3-1,3,1,1,1,4,2,H,"McQueen, Matt",3,Anfield
1925-02-14,1924,Liverpool,Newcastle United,1-1,1,1,1,1,2,0,D,"McQueen, Matt",1,Anfield
1925-02-28,1924,Sunderland,Liverpool,3-0,3,0,1,1,3,3,H,"McQueen, Matt",0,Away
1925-03-14,1924,Preston North End,Liverpool,4-0,4,0,1,1,4,4,H,"McQueen, Matt",0,Away
1925-03-16,1924,Sheffield United,Liverpool,0-1,0,1,1,1,1,-1,A,"McQueen, Matt",1,Away
1925-03-21,1924,Liverpool,Burnley,3-0,3,0,1,1,3,3,H,"McQueen, Matt",3,Anfield
1925-03-28,1924,Leeds United,Liverpool,4-1,4,1,1,1,5,3,H,"McQueen, Matt",1,Away
1925-04-04,1924,Liverpool,Birmingham City,1-1,1,1,1,1,2,0,D,"McQueen, Matt",1,Anfield
1925-04-10,1924,Liverpool,West Ham United,2-0,2,0,1,1,2,2,H,"McQueen, Matt",2,Anfield
1925-04-11,1924,West Bromwich Albion,Liverpool,0-0,0,0,1,1,0,0,D,"McQueen, Matt",0,Away
1925-04-13,1924,West Ham United,Liverpool,0-1,0,1,1,1,1,-1,A,"McQueen, Matt",1,Away
1925-04-18,1924,Liverpool,Tottenham Hotspur,1-0,1,0,1,1,1,1,H,"McQueen, Matt",1,Anfield
1925-04-25,1924,Bolton Wanderers,Liverpool,2-0,2,0,1,1,2,2,H,"McQueen, Matt",0,Away
1925-04-29,1924,Liverpool,Cardiff City,1-2,1,2,1,1,3,-1,A,"McQueen, Matt",1,Anfield
1925-05-02,1924,Huddersfield Town,Liverpool,1-1,1,1,1,1,2,0,D,"McQueen, Matt",1,Away
1925-08-29,1925,Leicester City,Liverpool,3-1,3,1,1,1,4,2,H,"McQueen, Matt",1,Away
1925-09-02,1925,Liverpool,Notts County,2-0,2,0,1,1,2,2,H,"McQueen, Matt",2,Anfield
1925-09-05,1925,Liverpool,West Ham United,0-0,0,0,1,1,0,0,D,"McQueen, Matt",0,Anfield
1925-09-12,1925,Arsenal,Liverpool,1-1,1,1,1,1,2,0,D,"McQueen, Matt",1,Away
1925-09-19,1925,Liverpool,Manchester United,5-0,5,0,1,1,5,5,H,"McQueen, Matt",5,Anfield
1925-09-26,1925,Liverpool,Everton,5-1,5,1,1,1,6,4,H,"McQueen, Matt",5,Anfield
1925-10-01,1925,Notts County,Liverpool,1-2,1,2,1,1,3,-1,A,"McQueen, Matt",2,Away
1925-10-03,1925,Burnley,Liverpool,2-1,2,1,1,1,3,1,H,"McQueen, Matt",1,Away
1925-10-10,1925,Liverpool,Leeds United,1-1,1,1,1,1,2,0,D,"McQueen, Matt",1,Anfield
1925-10-17,1925,Liverpool,Manchester City,2-1,2,1,1,1,3,1,H,"McQueen, Matt",2,Anfield
1925-10-24,1925,Tottenham Hotspur,Liverpool,3-1,3,1,1,1,4,2,H,"McQueen, Matt",1,Away
1925-10-31,1925,Liverpool,Sunderland,2-2,2,2,1,1,4,0,D,"McQueen, Matt",2,Anfield
1925-11-14,1925,Liverpool,West Bromwich Albion,2-0,2,0,1,1,2,2,H,"McQueen, Matt",2,Anfield
1925-11-21,1925,Birmingham City,Liverpool,2-0,2,0,1,1,2,2,H,"McQueen, Matt",0,Away
1925-11-25,1925,Huddersfield Town,Liverpool,0-0,0,0,1,1,0,0,D,"McQueen, Matt",0,Away
1925-11-28,1925,Liverpool,Bury,0-1,0,1,1,1,1,-1,A,"McQueen, Matt",0,Anfield
1925-12-05,1925,Blackburn Rovers,Liverpool,1-1,1,1,1,1,2,0,D,"McQueen, Matt",1,Away
1925-12-12,1925,Liverpool,Cardiff City,0-2,0,2,1,1,2,-2,A,"McQueen, Matt",0,Anfield
1925-12-19,1925,Sheffield United,Liverpool,3-1,3,1,1,1,4,2,H,"McQueen, Matt",1,Away
1925-12-25,1925,Liverpool,Newcastle United,6-3,6,3,1,1,9,3,H,"McQueen, Matt",6,Anfield
1925-12-26,1925,Newcastle United,Liverpool,3-0,3,0,1,1,3,3,H,"McQueen, Matt",0,Away
1926-01-01,1925,Liverpool,Aston Villa,3-1,3,1,1,1,4,2,H,"McQueen, Matt",3,Anfield
1926-01-02,1925,Liverpool,Leicester City,0-3,0,3,1,1,3,-3,A,"McQueen, Matt",0,Anfield
1926-01-16,1925,West Ham United,Liverpool,1-2,1,2,1,1,3,-1,A,"McQueen, Matt",2,Away
1926-01-23,1925,Liverpool,Arsenal,3-0,3,0,1,1,3,3,H,"McQueen, Matt",3,Anfield
1926-02-06,1925,Everton,Liverpool,3-3,3,3,1,1,6,0,D,"McQueen, Matt",3,Away
1926-02-13,1925,Liverpool,Burnley,3-2,3,2,1,1,5,1,H,"McQueen, Matt",3,Anfield
1926-02-20,1925,Leeds United,Liverpool,1-1,1,1,1,1,2,0,D,"McQueen, Matt",1,Away
1926-02-27,1925,Manchester City,Liverpool,1-1,1,1,1,1,2,0,D,"McQueen, Matt",1,Away
1926-03-06,1925,Liverpool,Tottenham Hotspur,0-0,0,0,1,1,0,0,D,"McQueen, Matt",0,Anfield
1926-03-10,1925,Manchester United,Liverpool,3-3,3,3,1,1,6,0,D,"McQueen, Matt",3,Away
1926-03-13,1925,Sunderland,Liverpool,3-2,3,2,1,1,5,1,H,"McQueen, Matt",2,Away
1926-03-20,1925,Liverpool,Huddersfield Town,1-2,1,2,1,1,3,-1,A,"McQueen, Matt",1,Anfield
1926-03-27,1925,West Bromwich Albion,Liverpool,0-3,0,3,1,1,3,-3,A,"McQueen, Matt",3,Away
1926-04-02,1925,Bolton Wanderers,Liverpool,0-1,0,1,1,1,1,-1,A,"McQueen, Matt",1,Away
1926-04-03,1925,Liverpool,Birmingham City,2-2,2,2,1,1,4,0,D,"McQueen, Matt",2,Anfield
1926-04-05,1925,Liverpool,Bolton Wanderers,2-2,2,2,1,1,4,0,D,"McQueen, Matt",2,Anfield
1926-04-06,1925,Aston Villa,Liverpool,3-0,3,0,1,1,3,3,H,"McQueen, Matt",0,Away
1926-04-10,1925,Bury,Liverpool,0-1,0,1,1,1,1,-1,A,"McQueen, Matt",1,Away
1926-04-17,1925,Liverpool,Blackburn Rovers,2-2,2,2,1,1,4,0,D,"McQueen, Matt",2,Anfield
1926-04-24,1925,Cardiff City,Liverpool,2-2,2,2,1,1,4,0,D,"McQueen, Matt",2,Away
1926-05-01,1925,Liverpool,Sheffield United,2-2,2,2,1,1,4,0,D,"McQueen, Matt",2,Anfield
1926-08-28,1926,Liverpool,Manchester United,4-2,4,2,1,1,6,2,H,"McQueen, Matt",4,Anfield
1926-08-30,1926,Aston Villa,Liverpool,1-1,1,1,1,1,2,0,D,"McQueen, Matt",1,Away
1926-09-04,1926,Derby County,Liverpool,2-1,2,1,1,1,3,1,H,"McQueen, Matt",1,Away
1926-09-08,1926,Liverpool,Aston Villa,2-1,2,1,1,1,3,1,H,"McQueen, Matt",2,Anfield
1926-09-11,1926,Liverpool,Sheffield United,5-1,5,1,1,1,6,4,H,"McQueen, Matt",5,Anfield
1926-09-18,1926,Arsenal,Liverpool,2-0,2,0,1,1,2,2,H,"McQueen, Matt",0,Away
1926-09-25,1926,Everton,Liverpool,1-0,1,0,1,1,1,1,H,"McQueen, Matt",0,Away
1926-10-02,1926,Liverpool,Leeds United,2-4,2,4,1,1,6,-2,A,"McQueen, Matt",2,Anfield
1926-10-09,1926,Newcastle United,Liverpool,1-0,1,0,1,1,1,1,H,"McQueen, Matt",0,Away
1926-10-16,1926,Sheffield Wednesday,Liverpool,3-2,3,2,1,1,5,1,H,"McQueen, Matt",2,Away
1926-10-23,1926,Liverpool,Leicester City,1-0,1,0,1,1,1,1,H,"McQueen, Matt",1,Anfield
1926-10-30,1926,Blackburn Rovers,Liverpool,2-1,2,1,1,1,3,1,H,"McQueen, Matt",1,Away
1926-11-06,1926,Liverpool,Huddersfield Town,2-3,2,3,1,1,5,-1,A,"McQueen, Matt",2,Anfield
1926-11-13,1926,Sunderland,Liverpool,2-1,2,1,1,1,3,1,H,"McQueen, Matt",1,Away
1926-11-20,1926,Liverpool,West Bromwich Albion,2-1,2,1,1,1,3,1,H,"McQueen, Matt",2,Anfield
1926-11-27,1926,Bury,Liverpool,0-2,0,2,1,1,2,-2,A,"McQueen, Matt",2,Away
1926-12-04,1926,Liverpool,Birmingham City,2-1,2,1,1,1,3,1,H,"McQueen, Matt",2,Anfield
1926-12-11,1926,Tottenham Hotspur,Liverpool,1-2,1,2,1,1,3,-1,A,"McQueen, Matt",2,Away
1926-12-18,1926,Liverpool,West Ham United,0-0,0,0,1,1,0,0,D,"McQueen, Matt",0,Anfield
1926-12-25,1926,Burnley,Liverpool,4-0,4,0,1,1,4,4,H,"McQueen, Matt",0,Away
1926-12-27,1926,Liverpool,Burnley,2-2,2,2,1,1,4,0,D,"McQueen, Matt",2,Anfield
1926-12-28,1926,Liverpool,Bolton Wanderers,3-2,3,2,1,1,5,1,H,"McQueen, Matt",3,Anfield
1927-01-01,1926,Bolton Wanderers,Liverpool,2-1,2,1,1,1,3,1,H,"McQueen, Matt",1,Away
1927-01-15,1926,Manchester United,Liverpool,0-1,0,1,1,1,1,-1,A,"McQueen, Matt",1,Away
1927-01-22,1926,Liverpool,Derby County,3-2,3,2,1,1,5,1,H,"McQueen, Matt",3,Anfield
1927-02-05,1926,Liverpool,Arsenal,3-0,3,0,1,1,3,3,H,"McQueen, Matt",3,Anfield
1927-02-07,1926,Sheffield United,Liverpool,1-4,1,4,1,1,5,-3,A,"McQueen, Matt",4,Away
1927-02-12,1926,Liverpool,Everton,1-0,1,0,1,1,1,1,H,"McQueen, Matt",1,Anfield
1927-02-23,1926,Leeds United,Liverpool,0-0,0,0,1,1,0,0,D,"McQueen, Matt",0,Away
1927-02-26,1926,Liverpool,Newcastle United,1-2,1,2,1,1,3,-1,A,"McQueen, Matt",1,Anfield
1927-03-05,1926,Liverpool,Sheffield Wednesday,3-0,3,0,1,1,3,3,H,"McQueen, Matt",3,Anfield
1927-03-12,1926,Leicester City,Liverpool,3-2,3,2,1,1,5,1,H,"McQueen, Matt",2,Away
1927-03-19,1926,Liverpool,Blackburn Rovers,2-2,2,2,1,1,4,0,D,"McQueen, Matt",2,Anfield
1927-03-26,1926,Huddersfield Town,Liverpool,1-0,1,0,1,1,1,1,H,"McQueen, Matt",0,Away
1927-04-02,1926,Liverpool,Sunderland,1-2,1,2,1,1,3,-1,A,"McQueen, Matt",1,Anfield
1927-04-09,1926,West Bromwich Albion,Liverpool,0-1,0,1,1,1,1,-1,A,"McQueen, Matt",1,Away
1927-04-15,1926,Liverpool,Cardiff City,5-0,5,0,1,1,5,5,H,"McQueen, Matt",5,Anfield
1927-04-16,1926,Liverpool,Bury,2-2,2,2,1,1,4,0,D,"McQueen, Matt",2,Anfield
1927-04-18,1926,Cardiff City,Liverpool,2-0,2,0,1,1,2,2,H,"McQueen, Matt",0,Away
1927-04-23,1926,Birmingham City,Liverpool,3-0,3,0,1,1,3,3,H,"McQueen, Matt",0,Away
1927-04-30,1926,Liverpool,Tottenham Hotspur,1-0,1,0,1,1,1,1,H,"McQueen, Matt",1,Anfield
1927-05-07,1926,West Ham United,Liverpool,3-3,3,3,1,1,6,0,D,"McQueen, Matt",3,Away
1927-08-27,1927,Sheffield United,Liverpool,1-1,1,1,1,1,2,0,D,"McQueen, Matt",1,Away
1927-08-31,1927,Liverpool,Bury,5-1,5,1,1,1,6,4,H,"McQueen, Matt",5,Anfield
1927-09-03,1927,Liverpool,Aston Villa,0-0,0,0,1,1,0,0,D,"McQueen, Matt",0,Anfield
1927-09-10,1927,Sunderland,Liverpool,2-1,2,1,1,1,3,1,H,"McQueen, Matt",1,Away
1927-09-17,1927,Liverpool,Derby County,5-2,5,2,1,1,7,3,H,"McQueen, Matt",5,Anfield
1927-09-19,1927,Bury,Liverpool,5-2,5,2,1,1,7,3,H,"McQueen, Matt",2,Away
1927-09-24,1927,West Ham United,Liverpool,3-1,3,1,1,1,4,2,H,"McQueen, Matt",1,Away
1927-10-01,1927,Liverpool,Portsmouth,8-2,8,2,1,1,10,6,H,"McQueen, Matt",8,Anfield
1927-10-08,1927,Leicester City,Liverpool,1-1,1,1,1,1,2,0,D,"McQueen, Matt",1,Away
1927-10-15,1927,Everton,Liverpool,1-1,1,1,1,1,2,0,D,"McQueen, Matt",1,Away
1927-10-22,1927,Bolton Wanderers,Liverpool,2-1,2,1,1,1,3,1,H,"McQueen, Matt",1,Away
1927-10-29,1927,Liverpool,Blackburn Rovers,4-2,4,2,1,1,6,2,H,"McQueen, Matt",4,Anfield
1927-11-05,1927,Cardiff City,Liverpool,1-1,1,1,1,1,2,0,D,"McQueen, Matt",1,Away
1927-11-12,1927,Liverpool,Sheffield Wednesday,5-2,5,2,1,1,7,3,H,"McQueen, Matt",5,Anfield
1927-11-19,1927,Middlesbrough,Liverpool,1-1,1,1,1,1,2,0,D,"McQueen, Matt",1,Away
1927-11-26,1927,Liverpool,Huddersfield Town,4-2,4,2,1,1,6,2,H,"McQueen, Matt",4,Anfield
1927-12-03,1927,Newcastle United,Liverpool,1-1,1,1,1,1,2,0,D,"McQueen, Matt",1,Away
1927-12-10,1927,Liverpool,Birmingham City,2-3,2,3,1,1,5,-1,A,"McQueen, Matt",2,Anfield
1927-12-17,1927,Tottenham Hotspur,Liverpool,3-1,3,1,1,1,4,2,H,"McQueen, Matt",1,Away
1927-12-24,1927,Liverpool,Manchester United,2-0,2,0,1,1,2,2,H,"McQueen, Matt",2,Anfield
1927-12-27,1927,Liverpool,Arsenal,0-2,0,2,1,1,2,-2,A,"McQueen, Matt",0,Anfield
1927-12-31,1927,Liverpool,Sheffield United,2-1,2,1,1,1,3,1,H,"McQueen, Matt",2,Anfield
1928-01-02,1927,Liverpool,Burnley,2-2,2,2,1,1,4,0,D,"McQueen, Matt",2,Anfield
1928-01-07,1927,Aston Villa,Liverpool,3-4,3,4,1,1,7,-1,A,"McQueen, Matt",4,Away
1928-01-21,1927,Liverpool,Sunderland,2-5,2,5,1,1,7,-3,A,"McQueen, Matt",2,Anfield
1928-02-04,1927,Liverpool,West Ham United,1-3,1,3,1,1,4,-2,A,"McQueen, Matt",1,Anfield
1928-02-11,1927,Portsmouth,Liverpool,1-0,1,0,1,1,1,1,H,"McQueen, Matt",0,Away
1928-02-15,1927,Derby County,Liverpool,2-3,2,3,1,1,5,-1,A,"McQueen, Matt",3,Away
1928-02-25,1927,Liverpool,Everton,3-3,3,3,1,1,6,0,D,,3,Anfield
1928-03-03,1927,Liverpool,Bolton Wanderers,4-2,4,2,1,1,6,2,H,,4,Anfield
1928-03-07,1927,Arsenal,Liverpool,6-3,6,3,1,1,9,3,H,"Patterson, George",3,Away
1928-03-10,1927,Blackburn Rovers,Liverpool,2-1,2,1,1,1,3,1,H,"Patterson, George",1,Away
1928-03-17,1927,Liverpool,Cardiff City,1-2,1,2,1,1,3,-1,A,"Patterson, George",1,Anfield
1928-03-24,1927,Sheffield Wednesday,Liverpool,4-0,4,0,1,1,4,4,H,"Patterson, George",0,Away
1928-03-31,1927,Liverpool,Middlesbrough,1-1,1,1,1,1,2,0,D,"Patterson, George",1,Anfield
1928-04-06,1927,Burnley,Liverpool,2-2,2,2,1,1,4,0,D,"Patterson, George",2,Away
1928-04-07,1927,Huddersfield Town,Liverpool,2-4,2,4,1,1,6,-2,A,"Patterson, George",4,Away
1928-04-14,1927,Liverpool,Newcastle United,0-0,0,0,1,1,0,0,D,"Patterson, George",0,Anfield
1928-04-21,1927,Birmingham City,Liverpool,2-0,2,0,1,1,2,2,H,"Patterson, George",0,Away
1928-04-25,1927,Liverpool,Leicester City,1-1,1,1,1,1,2,0,D,"Patterson, George",1,Anfield
1928-04-28,1927,Liverpool,Tottenham Hotspur,2-0,2,0,1,1,2,2,H,"Patterson, George",2,Anfield
1928-05-05,1927,Manchester United,Liverpool,6-1,6,1,1,1,7,5,H,"Patterson, George",1,Away
1928-08-25,1928,Liverpool,Bury,3-0,3,0,1,1,3,3,H,"Patterson, George",3,Anfield
1928-09-01,1928,Aston Villa,Liverpool,3-1,3,1,1,1,4,2,H,"Patterson, George",1,Away
1928-09-05,1928,Liverpool,Sheffield United,1-2,1,2,1,1,3,-1,A,"Patterson, George",1,Anfield
1928-09-08,1928,Liverpool,Leicester City,6-3,6,3,1,1,9,3,H,"Patterson, George",6,Anfield
1928-09-10,1928,Sheffield United,Liverpool,1-3,1,3,1,1,4,-2,A,"Patterson, George",3,Away
1928-09-15,1928,Manchester United,Liverpool,2-2,2,2,1,1,4,0,D,"Patterson, George",2,Away
1928-09-22,1928,Liverpool,Leeds United,1-1,1,1,1,1,2,0,D,"Patterson, George",1,Anfield
1928-09-29,1928,Everton,Liverpool,1-0,1,0,1,1,1,1,H,"Patterson, George",0,Away
1928-10-06,1928,West Ham United,Liverpool,1-1,1,1,1,1,2,0,D,"Patterson, George",1,Away
1928-10-13,1928,Liverpool,Newcastle United,2-1,2,1,1,1,3,1,H,"Patterson, George",2,Anfield
1928-10-20,1928,Liverpool,Huddersfield Town,2-3,2,3,1,1,5,-1,A,"Patterson, George",2,Anfield
1928-10-27,1928,Arsenal,Liverpool,4-4,4,4,1,1,8,0,D,"Patterson, George",4,Away
1928-11-03,1928,Liverpool,Birmingham City,1-2,1,2,1,1,3,-1,A,"Patterson, George",1,Anfield
1928-11-10,1928,Portsmouth,Liverpool,0-1,0,1,1,1,1,-1,A,"Patterson, George",1,Away
1928-11-17,1928,Liverpool,Bolton Wanderers,3-0,3,0,1,1,3,3,H,"Patterson, George",3,Anfield
1928-11-24,1928,Sheffield Wednesday,Liverpool,3-2,3,2,1,1,5,1,H,"Patterson, George",2,Away
1928-12-01,1928,Liverpool,Derby County,3-0,3,0,1,1,3,3,H,"Patterson, George",3,Anfield
1928-12-08,1928,Sunderland,Liverpool,2-1,2,1,1,1,3,1,H,"Patterson, George",1,Away
1928-12-15,1928,Liverpool,Blackburn Rovers,1-1,1,1,1,1,2,0,D,"Patterson, George",1,Anfield
1928-12-22,1928,Manchester City,Liverpool,2-3,2,3,1,1,5,-1,A,"Patterson, George",3,Away
1928-12-25,1928,Burnley,Liverpool,3-2,3,2,1,1,5,1,H,"Patterson, George",2,Away
1928-12-26,1928,Liverpool,Burnley,8-0,8,0,1,1,8,8,H,"Patterson, George",8,Anfield
1928-12-29,1928,Bury,Liverpool,2-2,2,2,1,1,4,0,D,"Patterson, George",2,Away
1929-01-05,1928,Liverpool,Aston Villa,4-0,4,0,1,1,4,4,H,"Patterson, George",4,Anfield
1929-01-19,1928,Leicester City,Liverpool,2-0,2,0,1,1,2,2,H,"Patterson, George",0,Away
1929-02-02,1928,Leeds United,Liverpool,2-2,2,2,1,1,4,0,D,"Patterson, George",2,Away
1929-02-09,1928,Liverpool,Everton,1-2,1,2,1,1,3,-1,A,"Patterson, George",1,Anfield
1929-02-13,1928,Liverpool,Manchester United,2-3,2,3,1,1,5,-1,A,"Patterson, George",2,Anfield
1929-02-23,1928,Newcastle United,Liverpool,2-2,2,2,1,1,4,0,D,"Patterson, George",2,Away
1929-03-09,1928,Liverpool,Arsenal,2-4,2,4,1,1,6,-2,A,"Patterson, George",2,Anfield
1929-03-13,1928,Liverpool,West Ham United,2-1,2,1,1,1,3,1,H,"Patterson, George",2,Anfield
1929-03-16,1928,Birmingham City,Liverpool,0-0,0,0,1,1,0,0,D,"Patterson, George",0,Away
1929-03-29,1928,Liverpool,Cardiff City,2-0,2,0,1,1,2,2,H,"Patterson, George",2,Anfield
1929-03-30,1928,Bolton Wanderers,Liverpool,0-0,0,0,1,1,0,0,D,"Patterson, George",0,Away
1929-04-01,1928,Cardiff City,Liverpool,1-2,1,2,1,1,3,-1,A,"Patterson, George",2,Away
1929-04-06,1928,Liverpool,Sheffield Wednesday,3-2,3,2,1,1,5,1,H,"Patterson, George",3,Anfield
1929-04-10,1928,Huddersfield Town,Liverpool,1-3,1,3,1,1,4,-2,A,"Patterson, George",3,Away
1929-04-13,1928,Derby County,Liverpool,2-5,2,5,1,1,7,-3,A,"Patterson, George",5,Away
1929-04-17,1928,Liverpool,Portsmouth,0-0,0,0,1,1,0,0,D,"Patterson, George",0,Anfield
1929-04-20,1928,Liverpool,Sunderland,5-2,5,2,1,1,7,3,H,"Patterson, George",5,Anfield
1929-04-27,1928,Blackburn Rovers,Liverpool,2-1,2,1,1,1,3,1,H,"Patterson, George",1,Away
1929-05-04,1928,Liverpool,Manchester City,1-1,1,1,1,1,2,0,D,"Patterson, George",1,Anfield
1929-08-31,1929,Middlesbrough,Liverpool,5-0,5,0,1,1,5,5,H,"Patterson, George",0,Away
1929-09-04,1929,Liverpool,Huddersfield Town,3-0,3,0,1,1,3,3,H,"Patterson, George",3,Anfield
1929-09-07,1929,Liverpool,Everton,0-3,0,3,1,1,3,-3,A,"Patterson, George",0,Anfield
1929-09-14,1929,Liverpool,West Ham United,3-1,3,1,1,1,4,2,H,"Patterson, George",3,Anfield
1929-09-16,1929,Huddersfield Town,Liverpool,3-0,3,0,1,1,3,3,H,"Patterson, George",0,Away
1929-09-21,1929,Manchester United,Liverpool,1-2,1,2,1,1,3,-1,A,"Patterson, George",2,Away
1929-09-28,1929,Liverpool,Grimsby Town,2-0,2,0,1,1,2,2,H,"Patterson, George",2,Anfield
1929-10-05,1929,Leicester City,Liverpool,2-1,2,1,1,1,3,1,H,"Patterson, George",1,Away
1929-10-09,1929,Liverpool,Blackburn Rovers,1-1,1,1,1,1,2,0,D,"Patterson, George",1,Anfield
1929-10-12,1929,Liverpool,Birmingham City,1-1,1,1,1,1,2,0,D,"Patterson, George",1,Anfield
1929-10-19,1929,Derby County,Liverpool,2-2,2,2,1,1,4,0,D,"Patterson, George",2,Away
1929-10-26,1929,Liverpool,Manchester City,1-6,1,6,1,1,7,-5,A,"Patterson, George",1,Anfield
1929-11-02,1929,Portsmouth,Liverpool,3-3,3,3,1,1,6,0,D,"Patterson, George",3,Away
1929-11-09,1929,Liverpool,Bolton Wanderers,3-0,3,0,1,1,3,3,H,"Patterson, George",3,Anfield
1929-11-16,1929,Aston Villa,Liverpool,2-3,2,3,1,1,5,-1,A,"Patterson, George",3,Away
1929-11-23,1929,Liverpool,Leeds United,1-0,1,0,1,1,1,1,H,"Patterson, George",1,Anfield
1929-11-30,1929,Sheffield Wednesday,Liverpool,2-1,2,1,1,1,3,1,H,"Patterson, George",1,Away
1929-12-07,1929,Liverpool,Burnley,1-3,1,3,1,1,4,-2,A,"Patterson, George",1,Anfield
1929-12-14,1929,Sunderland,Liverpool,2-3,2,3,1,1,5,-1,A,"Patterson, George",3,Away
1929-12-21,1929,Liverpool,Arsenal,1-0,1,0,1,1,1,1,H,"Patterson, George",1,Anfield
1929-12-25,1929,Sheffield United,Liverpool,4-0,4,0,1,1,4,4,H,"Patterson, George",0,Away
1929-12-26,1929,Liverpool,Sheffield United,2-0,2,0,1,1,2,2,H,"Patterson, George",2,Anfield
1929-12-28,1929,Liverpool,Middlesbrough,5-2,5,2,1,1,7,3,H,"Patterson, George",5,Anfield
1930-01-04,1929,Everton,Liverpool,3-3,3,3,1,1,6,0,D,"Patterson, George",3,Away
1930-01-18,1929,West Ham United,Liverpool,4-1,4,1,1,1,5,3,H,"Patterson, George",1,Away
1930-01-25,1929,Liverpool,Manchester United,1-0,1,0,1,1,1,1,H,"Patterson, George",1,Anfield
1930-02-01,1929,Grimsby Town,Liverpool,3-2,3,2,1,1,5,1,H,"Patterson, George",2,Away
1930-02-08,1929,Liverpool,Leicester City,1-1,1,1,1,1,2,0,D,"Patterson, George",1,Anfield
1930-02-15,1929,Birmingham City,Liverpool,1-0,1,0,1,1,1,1,H,"Patterson, George",0,Away
1930-02-22,1929,Liverpool,Derby County,2-2,2,2,1,1,4,0,D,"Patterson, George",2,Anfield
1930-03-01,1929,Manchester City,Liverpool,4-3,4,3,1,1,7,1,H,"Patterson, George",3,Away
1930-03-08,1929,Liverpool,Portsmouth,2-0,2,0,1,1,2,2,H,"Patterson, George",2,Anfield
1930-03-15,1929,Bolton Wanderers,Liverpool,0-2,0,2,1,1,2,-2,A,"Patterson, George",2,Away
1930-03-22,1929,Liverpool,Aston Villa,2-0,2,0,1,1,2,2,H,"Patterson, George",2,Anfield
1930-03-29,1929,Leeds United,Liverpool,1-1,1,1,1,1,2,0,D,"Patterson, George",1,Away
1930-04-02,1929,Arsenal,Liverpool,0-1,0,1,1,1,1,-1,A,"Patterson, George",1,Away
1930-04-05,1929,Liverpool,Sheffield Wednesday,1-3,1,3,1,1,4,-2,A,"Patterson, George",1,Anfield
1930-04-12,1929,Burnley,Liverpool,4-1,4,1,1,1,5,3,H,"Patterson, George",1,Away
1930-04-18,1929,Newcastle United,Liverpool,3-1,3,1,1,1,4,2,H,"Patterson, George",1,Away
1930-04-19,1929,Liverpool,Sunderland,0-6,0,6,1,1,6,-6,A,"Patterson, George",0,Anfield
1930-04-21,1929,Liverpool,Newcastle United,0-0,0,0,1,1,0,0,D,"Patterson, George",0,Anfield
1930-05-03,1929,Blackburn Rovers,Liverpool,1-0,1,0,1,1,1,1,H,"Patterson, George",0,Away
1930-08-30,1930,Liverpool,Blackburn Rovers,2-1,2,1,1,1,3,1,H,"Patterson, George",2,Anfield
1930-09-01,1930,West Ham United,Liverpool,7-0,7,0,1,1,7,7,H,"Patterson, George",0,Away
1930-09-06,1930,Middlesbrough,Liverpool,3-3,3,3,1,1,6,0,D,"Patterson, George",3,Away
1930-09-10,1930,Liverpool,Bolton Wanderers,7-2,7,2,1,1,9,5,H,"Patterson, George",7,Anfield
1930-09-13,1930,Liverpool,Huddersfield Town,1-4,1,4,1,1,5,-3,A,"Patterson, George",1,Anfield
1930-09-20,1930,Aston Villa,Liverpool,4-2,4,2,1,1,6,2,H,"Patterson, George",2,Away
1930-09-27,1930,Liverpool,Chelsea,3-1,3,1,1,1,4,2,H,"Patterson, George",3,Anfield
1930-10-04,1930,Newcastle United,Liverpool,0-4,0,4,1,1,4,-4,A,"Patterson, George",4,Away
1930-10-11,1930,Liverpool,Sheffield Wednesday,1-2,1,2,1,1,3,-1,A,"Patterson, George",1,Anfield
1930-10-18,1930,Liverpool,Leeds United,2-0,2,0,1,1,2,2,H,"Patterson, George",2,Anfield
1930-10-25,1930,Blackpool,Liverpool,1-3,1,3,1,1,4,-2,A,"Patterson, George",3,Away
1930-11-01,1930,Liverpool,Manchester City,0-2,0,2,1,1,2,-2,A,"Patterson, George",0,Anfield
1930-11-08,1930,Derby County,Liverpool,2-2,2,2,1,1,4,0,D,"Patterson, George",2,Away
1930-11-15,1930,Liverpool,Leicester City,3-1,3,1,1,1,4,2,H,"Patterson, George",3,Anfield
1930-11-22,1930,Portsmouth,Liverpool,4-0,4,0,1,1,4,4,H,"Patterson, George",0,Away
1930-11-29,1930,Liverpool,Sheffield United,6-1,6,1,1,1,7,5,H,"Patterson, George",6,Anfield
1930-12-06,1930,Sunderland,Liverpool,6-5,6,5,1,1,11,1,H,"Patterson, George",5,Away
1930-12-13,1930,Liverpool,Arsenal,1-1,1,1,1,1,2,0,D,"Patterson, George",1,Anfield
1930-12-20,1930,Birmingham City,Liverpool,2-0,2,0,1,1,2,2,H,"Patterson, George",0,Away
1930-12-25,1930,Grimsby Town,Liverpool,0-0,0,0,1,1,0,0,D,"Patterson, George",0,Away
1930-12-26,1930,Liverpool,Grimsby Town,1-1,1,1,1,1,2,0,D,"Patterson, George",1,Anfield
1930-12-27,1930,Blackburn Rovers,Liverpool,3-3,3,3,1,1,6,0,D,"Patterson, George",3,Away
1931-01-03,1930,Liverpool,Middlesbrough,3-1,3,1,1,1,4,2,H,"Patterson, George",3,Anfield
1931-01-14,1930,Bolton Wanderers,Liverpool,2-0,2,0,1,1,2,2,H,"Patterson, George",0,Away
1931-01-17,1930,Huddersfield Town,Liverpool,2-1,2,1,1,1,3,1,H,"Patterson, George",1,Away
1931-01-24,1930,Liverpool,Aston Villa,1-1,1,1,1,1,2,0,D,"Patterson, George",1,Anfield
1931-01-31,1930,Chelsea,Liverpool,2-2,2,2,1,1,4,0,D,"Patterson, George",2,Away
1931-02-07,1930,Liverpool,Newcastle United,4-2,4,2,1,1,6,2,H,"Patterson, George",4,Anfield
1931-02-14,1930,Sheffield Wednesday,Liverpool,3-5,3,5,1,1,8,-2,A,"Patterson, George",5,Away
1931-02-21,1930,Leeds United,Liverpool,1-2,1,2,1,1,3,-1,A,"Patterson, George",2,Away
1931-02-28,1930,Liverpool,Blackpool,5-2,5,2,1,1,7,3,H,"Patterson, George",5,Anfield
1931-03-07,1930,Manchester City,Liverpool,1-1,1,1,1,1,2,0,D,"Patterson, George",1,Away
1931-03-14,1930,Liverpool,Derby County,0-0,0,0,1,1,0,0,D,"Patterson, George",0,Anfield
1931-03-21,1930,Leicester City,Liverpool,3-2,3,2,1,1,5,1,H,"Patterson, George",2,Away
1931-03-28,1930,Liverpool,Portsmouth,3-1,3,1,1,1,4,2,H,"Patterson, George",3,Anfield
1931-04-03,1930,Liverpool,Manchester United,1-1,1,1,1,1,2,0,D,"Patterson, George",1,Anfield
1931-04-04,1930,Sheffield United,Liverpool,4-1,4,1,1,1,5,3,H,"Patterson, George",1,Away
1931-04-06,1930,Manchester United,Liverpool,4-1,4,1,1,1,5,3,H,"Patterson, George",1,Away
1931-04-11,1930,Liverpool,Sunderland,2-4,2,4,1,1,6,-2,A,"Patterson, George",2,Anfield
1931-04-15,1930,Liverpool,Birmingham City,0-0,0,0,1,1,0,0,D,"Patterson, George",0,Anfield
1931-04-18,1930,Arsenal,Liverpool,3-1,3,1,1,1,4,2,H,"Patterson, George",1,Away
1931-05-02,1930,Liverpool,West Ham United,2-0,2,0,1,1,2,2,H,"Patterson, George",2,Anfield
1931-08-29,1931,Newcastle United,Liverpool,0-1,0,1,1,1,1,-1,A,"Patterson, George",1,Away
1931-09-02,1931,Liverpool,Bolton Wanderers,2-2,2,2,1,1,4,0,D,"Patterson, George",2,Anfield
1931-09-05,1931,Liverpool,Aston Villa,2-0,2,0,1,1,2,2,H,"Patterson, George",2,Anfield
1931-09-09,1931,Middlesbrough,Liverpool,4-1,4,1,1,1,5,3,H,"Patterson, George",1,Away
1931-09-12,1931,Leicester City,Liverpool,2-1,2,1,1,1,3,1,H,"Patterson, George",1,Away
1931-09-16,1931,Liverpool,Middlesbrough,7-2,7,2,1,1,9,5,H,"Patterson, George",7,Anfield
1931-09-19,1931,Liverpool,Everton,1-3,1,3,1,1,4,-2,A,"Patterson, George",1,Anfield
1931-09-26,1931,Liverpool,Grimsby Town,4-0,4,0,1,1,4,4,H,"Patterson, George",4,Anfield
1931-10-03,1931,Chelsea,Liverpool,2-0,2,0,1,1,2,2,H,"Patterson, George",0,Away
1931-10-10,1931,Liverpool,West Ham United,2-2,2,2,1,1,4,0,D,"Patterson, George",2,Anfield
1931-10-17,1931,West Bromwich Albion,Liverpool,1-2,1,2,1,1,3,-1,A,"Patterson, George",2,Away
1931-10-24,1931,Liverpool,Blackpool,3-2,3,2,1,1,5,1,H,"Patterson, George",3,Anfield
1931-10-31,1931,Sheffield United,Liverpool,3-0,3,0,1,1,3,3,H,"Patterson, George",0,Away
1931-11-07,1931,Liverpool,Blackburn Rovers,4-2,4,2,1,1,6,2,H,"Patterson, George",4,Anfield
1931-11-14,1931,Sunderland,Liverpool,1-3,1,3,1,1,4,-2,A,"Patterson, George",3,Away
1931-11-21,1931,Liverpool,Manchester City,4-3,4,3,1,1,7,1,H,"Patterson, George",4,Anfield
1931-11-28,1931,Arsenal,Liverpool,6-0,6,0,1,1,6,6,H,"Patterson, George",0,Away
1931-12-05,1931,Liverpool,Birmingham City,4-3,4,3,1,1,7,1,H,"Patterson, George",4,Anfield
1931-12-12,1931,Portsmouth,Liverpool,2-0,2,0,1,1,2,2,H,"Patterson, George",0,Away
1931-12-19,1931,Liverpool,Derby County,1-1,1,1,1,1,2,0,D,"Patterson, George",1,Anfield
1931-12-25,1931,Liverpool,Sheffield Wednesday,3-1,3,1,1,1,4,2,H,"Patterson, George",3,Anfield
1931-12-26,1931,Sheffield Wednesday,Liverpool,1-1,1,1,1,1,2,0,D,"Patterson, George",1,Away
1932-01-02,1931,Liverpool,Newcastle United,4-2,4,2,1,1,6,2,H,"Patterson, George",4,Anfield
1932-01-16,1931,Aston Villa,Liverpool,6-1,6,1,1,1,7,5,H,"Patterson, George",1,Away
1932-01-27,1931,Liverpool,Leicester City,3-3,3,3,1,1,6,0,D,"Patterson, George",3,Anfield
1932-01-30,1931,Everton,Liverpool,2-1,2,1,1,1,3,1,H,"Patterson, George",1,Away
1932-02-06,1931,Grimsby Town,Liverpool,5-1,5,1,1,1,6,4,H,"Patterson, George",1,Away
1932-02-20,1931,West Ham United,Liverpool,1-0,1,0,1,1,1,1,H,"Patterson, George",0,Away
1932-03-02,1931,Liverpool,West Bromwich Albion,4-1,4,1,1,1,5,3,H,"Patterson, George",4,Anfield
1932-03-05,1931,Blackpool,Liverpool,2-2,2,2,1,1,4,0,D,"Patterson, George",2,Away
1932-03-12,1931,Liverpool,Sheffield United,2-1,2,1,1,1,3,1,H,"Patterson, George",2,Anfield
1932-03-19,1931,Blackburn Rovers,Liverpool,1-3,1,3,1,1,4,-2,A,"Patterson, George",3,Away
1932-03-26,1931,Liverpool,Sunderland,1-2,1,2,1,1,3,-1,A,"Patterson, George",1,Anfield
1932-03-28,1931,Liverpool,Huddersfield Town,0-3,0,3,1,1,3,-3,A,"Patterson, George",0,Anfield
1932-03-29,1931,Huddersfield Town,Liverpool,4-3,4,3,1,1,7,1,H,"Patterson, George",3,Away
1932-04-02,1931,Manchester City,Liverpool,0-1,0,1,1,1,1,-1,A,"Patterson, George",1,Away
1932-04-06,1931,Liverpool,Chelsea,2-1,2,1,1,1,3,1,H,"Patterson, George",2,Anfield
1932-04-09,1931,Liverpool,Arsenal,2-1,2,1,1,1,3,1,H,"Patterson, George",2,Anfield
1932-04-16,1931,Birmingham City,Liverpool,3-1,3,1,1,1,4,2,H,"Patterson, George",1,Away
1932-04-23,1931,Liverpool,Portsmouth,1-3,1,3,1,1,4,-2,A,"Patterson, George",1,Anfield
1932-04-30,1931,Derby County,Liverpool,1-2,1,2,1,1,3,-1,A,"Patterson, George",2,Away
1932-05-07,1931,Bolton Wanderers,Liverpool,8-1,8,1,1,1,9,7,H,"Patterson, George",1,Away
1932-08-27,1932,Liverpool,Wolverhampton Wanderers,5-1,5,1,1,1,6,4,H,"Patterson, George",5,Anfield
1932-08-29,1932,Sheffield United,Liverpool,6-2,6,2,1,1,8,4,H,"Patterson, George",2,Away
1932-09-03,1932,Newcastle United,Liverpool,4-3,4,3,1,1,7,1,H,"Patterson, George",3,Away
1932-09-07,1932,Liverpool,Sheffield United,2-2,2,2,1,1,4,0,D,"Patterson, George",2,Anfield
1932-09-10,1932,Liverpool,Aston Villa,0-0,0,0,1,1,0,0,D,"Patterson, George",0,Anfield
1932-09-17,1932,Middlesbrough,Liverpool,0-1,0,1,1,1,1,-1,A,"Patterson, George",1,Away
1932-09-24,1932,Liverpool,Bolton Wanderers,0-1,0,1,1,1,1,-1,A,"Patterson, George",0,Anfield
1932-10-01,1932,Everton,Liverpool,3-1,3,1,1,1,4,2,H,"Patterson, George",1,Away
1932-10-08,1932,Leicester City,Liverpool,1-2,1,2,1,1,3,-1,A,"Patterson, George",2,Away
1932-10-15,1932,Liverpool,Portsmouth,4-3,4,3,1,1,7,1,H,"Patterson, George",4,Anfield
1932-10-22,1932,Liverpool,Arsenal,2-3,2,3,1,1,5,-1,A,"Patterson, George",2,Anfield
1932-10-29,1932,Manchester City,Liverpool,1-1,1,1,1,1,2,0,D,"Patterson, George",1,Away
1932-11-05,1932,Liverpool,Leeds United,0-1,0,1,1,1,1,-1,A,"Patterson, George",0,Anfield
1932-11-12,1932,Blackburn Rovers,Liverpool,2-2,2,2,1,1,4,0,D,"Patterson, George",2,Away
1932-11-19,1932,Liverpool,Derby County,6-1,6,1,1,1,7,5,H,"Patterson, George",6,Anfield
1932-11-26,1932,Blackpool,Liverpool,4-1,4,1,1,1,5,3,H,"Patterson, George",1,Away
1932-12-03,1932,Liverpool,Sunderland,3-3,3,3,1,1,6,0,D,"Patterson, George",3,Anfield
1932-12-10,1932,Birmingham City,Liverpool,3-0,3,0,1,1,3,3,H,"Patterson, George",0,Away
1932-12-17,1932,Liverpool,West Bromwich Albion,2-0,2,0,1,1,2,2,H,"Patterson, George",2,Anfield
1932-12-24,1932,Sheffield Wednesday,Liverpool,3-0,3,0,1,1,3,3,H,"Patterson, George",0,Away
1932-12-26,1932,Liverpool,Chelsea,3-0,3,0,1,1,3,3,H,"Patterson, George",3,Anfield
1932-12-27,1932,Chelsea,Liverpool,0-2,0,2,1,1,2,-2,A,"Patterson, George",2,Away
1932-12-31,1932,Wolverhampton Wanderers,Liverpool,3-1,3,1,1,1,4,2,H,"Patterson, George",1,Away
1933-01-07,1932,Liverpool,Newcastle United,3-0,3,0,1,1,3,3,H,"Patterson, George",3,Anfield
1933-01-21,1932,Aston Villa,Liverpool,5-2,5,2,1,1,7,3,H,"Patterson, George",2,Away
1933-02-01,1932,Liverpool,Middlesbrough,1-3,1,3,1,1,4,-2,A,"Patterson, George",1,Anfield
1933-02-04,1932,Bolton Wanderers,Liverpool,3-3,3,3,1,1,6,0,D,"Patterson, George",3,Away
1933-02-11,1932,Liverpool,Everton,7-4,7,4,1,1,11,3,H,"Patterson, George",7,Anfield
1933-02-18,1932,Liverpool,Leicester City,1-2,1,2,1,1,3,-1,A,"Patterson, George",1,Anfield
1933-02-25,1932,Portsmouth,Liverpool,2-1,2,1,1,1,3,1,H,"Patterson, George",1,Away
1933-03-04,1932,Arsenal,Liverpool,0-1,0,1,1,1,1,-1,A,"Patterson, George",1,Away
1933-03-11,1932,Liverpool,Manchester City,1-1,1,1,1,1,2,0,D,"Patterson, George",1,Anfield
1933-03-18,1932,Leeds United,Liverpool,5-0,5,0,1,1,5,5,H,"Patterson, George",0,Away
1933-03-25,1932,Liverpool,Blackburn Rovers,2-2,2,2,1,1,4,0,D,"Patterson, George",2,Anfield
1933-04-01,1932,Derby County,Liverpool,1-1,1,1,1,1,2,0,D,"Patterson, George",1,Away
1933-04-08,1932,Liverpool,Blackpool,4-3,4,3,1,1,7,1,H,"Patterson, George",4,Anfield
1933-04-14,1932,Liverpool,Huddersfield Town,2-2,2,2,1,1,4,0,D,"Patterson, George",2,Anfield
1933-04-15,1932,Sunderland,Liverpool,0-0,0,0,1,1,0,0,D,"Patterson, George",0,Away
1933-04-18,1932,Huddersfield Town,Liverpool,3-1,3,1,1,1,4,2,H,"Patterson, George",1,Away
1933-04-22,1932,Liverpool,Birmingham City,1-0,1,0,1,1,1,1,H,"Patterson, George",1,Anfield
1933-04-29,1932,West Bromwich Albion,Liverpool,2-1,2,1,1,1,3,1,H,"Patterson, George",1,Away
1933-05-06,1932,Liverpool,Sheffield Wednesday,4-1,4,1,1,1,5,3,H,"Patterson, George",4,Anfield
1933-08-26,1933,Wolverhampton Wanderers,Liverpool,3-2,3,2,1,1,5,1,H,"Patterson, George",2,Away
1933-08-30,1933,Liverpool,Stoke City,1-1,1,1,1,1,2,0,D,"Patterson, George",1,Anfield
1933-09-02,1933,Liverpool,Sheffield United,3-2,3,2,1,1,5,1,H,"Patterson, George",3,Anfield
1933-09-04,1933,Stoke City,Liverpool,1-1,1,1,1,1,2,0,D,"Patterson, George",1,Away
1933-09-09,1933,Aston Villa,Liverpool,4-2,4,2,1,1,6,2,H,"Patterson, George",2,Away
1933-09-16,1933,Liverpool,Leicester City,1-3,1,3,1,1,4,-2,A,"Patterson, George",1,Anfield
1933-09-23,1933,Tottenham Hotspur,Liverpool,0-3,0,3,1,1,3,-3,A,"Patterson, George",3,Away
1933-09-30,1933,Liverpool,Everton,3-2,3,2,1,1,5,1,H,"Patterson, George",3,Anfield
1933-10-07,1933,Liverpool,Chelsea,3-0,3,0,1,1,3,3,H,"Patterson, George",3,Anfield
1933-10-14,1933,Sunderland,Liverpool,4-1,4,1,1,1,5,3,H,"Patterson, George",1,Away
1933-10-21,1933,Middlesbrough,Liverpool,4-1,4,1,1,1,5,3,H,"Patterson, George",1,Away
1933-10-28,1933,Liverpool,Blackburn Rovers,4-0,4,0,1,1,4,4,H,"Patterson, George",4,Anfield
1933-11-04,1933,Birmingham City,Liverpool,1-2,1,2,1,1,3,-1,A,"Patterson, George",2,Away
1933-11-11,1933,Liverpool,Leeds United,4-3,4,3,1,1,7,1,H,"Patterson, George",4,Anfield
1933-11-18,1933,Derby County,Liverpool,3-1,3,1,1,1,4,2,H,"Patterson, George",1,Away
1933-11-25,1933,Liverpool,West Bromwich Albion,1-1,1,1,1,1,2,0,D,"Patterson, George",1,Anfield
1933-12-02,1933,Arsenal,Liverpool,2-1,2,1,1,1,3,1,H,"Patterson, George",1,Away
1933-12-09,1933,Liverpool,Sheffield Wednesday,1-3,1,3,1,1,4,-2,A,"Patterson, George",1,Anfield
1933-12-16,1933,Manchester City,Liverpool,2-1,2,1,1,1,3,1,H,"Patterson, George",1,Away
1933-12-23,1933,Liverpool,Newcastle United,1-2,1,2,1,1,3,-1,A,"Patterson, George",1,Anfield
1933-12-25,1933,Liverpool,Portsmouth,2-2,2,2,1,1,4,0,D,"Patterson, George",2,Anfield
1933-12-26,1933,Portsmouth,Liverpool,1-0,1,0,1,1,1,1,H,"Patterson, George",0,Away
1933-12-30,1933,Liverpool,Wolverhampton Wanderers,1-1,1,1,1,1,2,0,D,"Patterson, George",1,Anfield
1934-01-01,1933,Newcastle United,Liverpool,9-2,9,2,1,1,11,7,H,"Patterson, George",2,Away
1934-01-06,1933,Sheffield United,Liverpool,2-2,2,2,1,1,4,0,D,"Patterson, George",2,Away
1934-01-20,1933,Liverpool,Aston Villa,2-3,2,3,1,1,5,-1,A,"Patterson, George",2,Anfield
1934-02-01,1933,Leicester City,Liverpool,1-0,1,0,1,1,1,1,H,"Patterson, George",0,Away
1934-02-03,1933,Liverpool,Tottenham Hotspur,3-1,3,1,1,1,4,2,H,"Patterson, George",3,Anfield
1934-02-10,1933,Everton,Liverpool,0-0,0,0,1,1,0,0,D,"Patterson, George",0,Away
1934-02-21,1933,Chelsea,Liverpool,2-0,2,0,1,1,2,2,H,"Patterson, George",0,Away
1934-02-24,1933,Liverpool,Sunderland,1-1,1,1,1,1,2,0,D,"Patterson, George",1,Anfield
1934-03-03,1933,Liverpool,Middlesbrough,6-2,6,2,1,1,8,4,H,"Patterson, George",6,Anfield
1934-03-10,1933,Blackburn Rovers,Liverpool,3-1,3,1,1,1,4,2,H,"Patterson, George",1,Away
1934-03-17,1933,Liverpool,Birmingham City,4-1,4,1,1,1,5,3,H,"Patterson, George",4,Anfield
1934-03-24,1933,Leeds United,Liverpool,5-1,5,1,1,1,6,4,H,"Patterson, George",1,Away
1934-03-30,1933,Liverpool,Huddersfield Town,2-2,2,2,1,1,4,0,D,"Patterson, George",2,Anfield
1934-03-31,1933,Liverpool,Derby County,4-2,4,2,1,1,6,2,H,"Patterson, George",4,Anfield
1934-04-03,1933,Huddersfield Town,Liverpool,0-2,0,2,1,1,2,-2,A,"Patterson, George",2,Away
1934-04-07,1933,West Bromwich Albion,Liverpool,2-2,2,2,1,1,4,0,D,"Patterson, George",2,Away
1934-04-14,1933,Liverpool,Arsenal,2-3,2,3,1,1,5,-1,A,"Patterson, George",2,Anfield
1934-04-21,1933,Sheffield Wednesday,Liverpool,1-2,1,2,1,1,3,-1,A,"Patterson, George",2,Away
1934-05-02,1933,Liverpool,Manchester City,3-2,3,2,1,1,5,1,H,"Patterson, George",3,Anfield
1934-08-25,1934,Liverpool,Blackburn Rovers,2-0,2,0,1,1,2,2,H,"Patterson, George",2,Anfield
1934-08-29,1934,Manchester City,Liverpool,3-1,3,1,1,1,4,2,H,"Patterson, George",1,Away
1934-09-01,1934,Arsenal,Liverpool,8-1,8,1,1,1,9,7,H,"Patterson, George",1,Away
1934-09-05,1934,Liverpool,Manchester City,2-1,2,1,1,1,3,1,H,"Patterson, George",2,Anfield
1934-09-08,1934,Liverpool,Portsmouth,0-1,0,1,1,1,1,-1,A,"Patterson, George",0,Anfield
1934-09-15,1934,Everton,Liverpool,1-0,1,0,1,1,1,1,H,"Patterson, George",0,Away
1934-09-22,1934,Leeds United,Liverpool,0-3,0,3,1,1,3,-3,A,"Patterson, George",3,Away
1934-09-29,1934,Liverpool,West Bromwich Albion,3-2,3,2,1,1,5,1,H,"Patterson, George",3,Anfield
1934-10-06,1934,Sheffield Wednesday,Liverpool,4-1,4,1,1,1,5,3,H,"Patterson, George",1,Away
1934-10-13,1934,Liverpool,Birmingham City,5-4,5,4,1,1,9,1,H,"Patterson, George",5,Anfield
1934-10-20,1934,Liverpool,Grimsby Town,1-1,1,1,1,1,2,0,D,"Patterson, George",1,Anfield
1934-10-27,1934,Preston North End,Liverpool,2-2,2,2,1,1,4,0,D,"Patterson, George",2,Away
1934-11-03,1934,Liverpool,Wolverhampton Wanderers,2-1,2,1,1,1,3,1,H,"Patterson, George",2,Anfield
1934-11-10,1934,Huddersfield Town,Liverpool,8-0,8,0,1,1,8,8,H,"Patterson, George",0,Away
1934-11-17,1934,Liverpool,Leicester City,5-1,5,1,1,1,6,4,H,"Patterson, George",5,Anfield
1934-11-24,1934,Derby County,Liverpool,1-2,1,2,1,1,3,-1,A,"Patterson, George",2,Away
1934-12-01,1934,Liverpool,Aston Villa,3-1,3,1,1,1,4,2,H,"Patterson, George",3,Anfield
1934-12-08,1934,Chelsea,Liverpool,4-1,4,1,1,1,5,3,H,"Patterson, George",1,Away
1934-12-15,1934,Liverpool,Tottenham Hotspur,4-1,4,1,1,1,5,3,H,"Patterson, George",4,Anfield
1934-12-22,1934,Sunderland,Liverpool,2-3,2,3,1,1,5,-1,A,"Patterson, George",3,Away
1934-12-26,1934,Liverpool,Middlesbrough,2-2,2,2,1,1,4,0,D,"Patterson, George",2,Anfield
1934-12-29,1934,Blackburn Rovers,Liverpool,0-2,0,2,1,1,2,-2,A,"Patterson, George",2,Away
1935-01-01,1934,Middlesbrough,Liverpool,2-0,2,0,1,1,2,2,H,"Patterson, George",0,Away
1935-01-05,1934,Liverpool,Arsenal,0-2,0,2,1,1,2,-2,A,"Patterson, George",0,Anfield
1935-01-19,1934,Portsmouth,Liverpool,1-2,1,2,1,1,3,-1,A,"Patterson, George",2,Away
1935-02-02,1934,Liverpool,Leeds United,4-2,4,2,1,1,6,2,H,"Patterson, George",4,Anfield
1935-02-09,1934,West Bromwich Albion,Liverpool,1-1,1,1,1,1,2,0,D,"Patterson, George",1,Away
1935-02-20,1934,Liverpool,Sheffield Wednesday,1-2,1,2,1,1,3,-1,A,"Patterson, George",1,Anfield
1935-02-23,1934,Birmingham City,Liverpool,1-3,1,3,1,1,4,-2,A,"Patterson, George",3,Away
1935-03-02,1934,Grimsby Town,Liverpool,3-2,3,2,1,1,5,1,H,"Patterson, George",2,Away
1935-03-09,1934,Liverpool,Preston North End,0-0,0,0,1,1,0,0,D,"Patterson, George",0,Anfield
1935-03-16,1934,Wolverhampton Wanderers,Liverpool,5-3,5,3,1,1,8,2,H,"Patterson, George",3,Away
1935-03-20,1934,Liverpool,Everton,2-1,2,1,1,1,3,1,H,"Patterson, George",2,Anfield
1935-03-23,1934,Liverpool,Huddersfield Town,3-2,3,2,1,1,5,1,H,"Patterson, George",3,Anfield
1935-03-30,1934,Leicester City,Liverpool,3-1,3,1,1,1,4,2,H,"Patterson, George",1,Away
1935-04-06,1934,Liverpool,Derby County,1-3,1,3,1,1,4,-2,A,"Patterson, George",1,Anfield
1935-04-13,1934,Aston Villa,Liverpool,4-2,4,2,1,1,6,2,H,"Patterson, George",2,Away
1935-04-19,1934,Liverpool,Stoke City,5-0,5,0,1,1,5,5,H,"Patterson, George",5,Anfield
1935-04-20,1934,Liverpool,Chelsea,6-0,6,0,1,1,6,6,H,"Patterson, George",6,Anfield
1935-04-22,1934,Stoke City,Liverpool,1-1,1,1,1,1,2,0,D,"Patterson, George",1,Away
1935-04-27,1934,Tottenham Hotspur,Liverpool,5-1,5,1,1,1,6,4,H,"Patterson, George",1,Away
1935-05-04,1934,Liverpool,Sunderland,2-2,2,2,1,1,4,0,D,"Patterson, George",2,Anfield
1935-08-31,1935,Chelsea,Liverpool,2-2,2,2,1,1,4,0,D,"Patterson, George",2,Away
1935-09-04,1935,Liverpool,Manchester City,0-2,0,2,1,1,2,-2,A,"Patterson, George",0,Anfield
1935-09-07,1935,Liverpool,Everton,6-0,6,0,1,1,6,6,H,"Patterson, George",6,Anfield
1935-09-11,1935,Manchester City,Liverpool,6-0,6,0,1,1,6,6,H,"Patterson, George",0,Away
1935-09-14,1935,Liverpool,Grimsby Town,7-2,7,2,1,1,9,5,H,"Patterson, George",7,Anfield
1935-09-18,1935,Liverpool,Stoke City,2-0,2,0,1,1,2,2,H,"Patterson, George",2,Anfield
1935-09-21,1935,Leeds United,Liverpool,1-0,1,0,1,1,1,1,H,"Patterson, George",0,Away
1935-09-28,1935,Liverpool,West Bromwich Albion,5-0,5,0,1,1,5,5,H,"Patterson, George",5,Anfield
1935-10-05,1935,Sunderland,Liverpool,2-0,2,0,1,1,2,2,H,"Patterson, George",0,Away
1935-10-12,1935,Liverpool,Birmingham City,1-2,1,2,1,1,3,-1,A,"Patterson, George",1,Anfield
1935-10-19,1935,Bolton Wanderers,Liverpool,0-0,0,0,1,1,0,0,D,"Patterson, George",0,Away
1935-10-26,1935,Liverpool,Huddersfield Town,3-0,3,0,1,1,3,3,H,"Patterson, George",3,Anfield
1935-11-02,1935,Middlesbrough,Liverpool,2-2,2,2,1,1,4,0,D,"Patterson, George",2,Away
1935-11-09,1935,Liverpool,Aston Villa,3-2,3,2,1,1,5,1,H,"Patterson, George",3,Anfield
1935-11-16,1935,Wolverhampton Wanderers,Liverpool,3-1,3,1,1,1,4,2,H,"Patterson, George",1,Away
1935-11-23,1935,Liverpool,Derby County,0-0,0,0,1,1,0,0,D,"Patterson, George",0,Anfield
1935-11-30,1935,Portsmouth,Liverpool,2-1,2,1,1,1,3,1,H,"Patterson, George",1,Away
1935-12-07,1935,Liverpool,Preston North End,2-1,2,1,1,1,3,1,H,"Patterson, George",2,Anfield
1935-12-14,1935,Brentford,Liverpool,1-2,1,2,1,1,3,-1,A,"Patterson, George",2,Away
1935-12-21,1935,Liverpool,Sheffield Wednesday,1-0,1,0,1,1,1,1,H,"Patterson, George",1,Anfield
1935-12-25,1935,Liverpool,Arsenal,0-1,0,1,1,1,1,-1,A,"Patterson, George",0,Anfield
1935-12-26,1935,Arsenal,Liverpool,1-2,1,2,1,1,3,-1,A,"Patterson, George",2,Away
1935-12-28,1935,Liverpool,Chelsea,2-3,2,3,1,1,5,-1,A,"Patterson, George",2,Anfield
1936-01-04,1935,Everton,Liverpool,0-0,0,0,1,1,0,0,D,"Patterson, George",0,Away
1936-01-18,1935,Grimsby Town,Liverpool,0-0,0,0,1,1,0,0,D,"Patterson, George",0,Away
1936-02-01,1935,West Bromwich Albion,Liverpool,6-1,6,1,1,1,7,5,H,"Patterson, George",1,Away
1936-02-08,1935,Liverpool,Sunderland,0-3,0,3,1,1,3,-3,A,"Patterson, George",0,Anfield
1936-02-15,1935,Birmingham City,Liverpool,2-0,2,0,1,1,2,2,H,"Patterson, George",0,Away
1936-02-22,1935,Liverpool,Bolton Wanderers,1-1,1,1,1,1,2,0,D,"Patterson, George",1,Anfield
1936-02-29,1935,Aston Villa,Liverpool,3-0,3,0,1,1,3,3,H,"Patterson, George",0,Away
1936-03-07,1935,Liverpool,Portsmouth,2-0,2,0,1,1,2,2,H,"Patterson, George",2,Anfield
1936-03-14,1935,Huddersfield Town,Liverpool,1-0,1,0,1,1,1,1,H,"Patterson, George",0,Away
1936-03-18,1935,Liverpool,Leeds United,2-1,2,1,1,1,3,1,H,"Patterson, George",2,Anfield
1936-03-21,1935,Liverpool,Wolverhampton Wanderers,0-2,0,2,1,1,2,-2,A,"Patterson, George",0,Anfield
1936-03-28,1935,Derby County,Liverpool,2-2,2,2,1,1,4,0,D,"Patterson, George",2,Away
1936-04-04,1935,Liverpool,Middlesbrough,2-2,2,2,1,1,4,0,D,"Patterson, George",2,Anfield
1936-04-10,1935,Blackburn Rovers,Liverpool,2-2,2,2,1,1,4,0,D,"Patterson, George",2,Away
1936-04-11,1935,Preston North End,Liverpool,3-1,3,1,1,1,4,2,H,"Patterson, George",1,Away
1936-04-13,1935,Liverpool,Blackburn Rovers,4-1,4,1,1,1,5,3,H,"Patterson, George",4,Anfield
1936-04-18,1935,Liverpool,Brentford,0-0,0,0,1,1,0,0,D,"Patterson, George",0,Anfield
1936-04-25,1935,Sheffield Wednesday,Liverpool,0-0,0,0,1,1,0,0,D,"Patterson, George",0,Away
1936-05-02,1935,Stoke City,Liverpool,2-1,2,1,1,1,3,1,H,"Patterson, George",1,Away
1936-08-29,1936,Liverpool,Stoke City,2-1,2,1,1,1,3,1,H,"Kay, George",2,Anfield
1936-09-02,1936,Portsmouth,Liverpool,6-2,6,2,1,1,8,4,H,"Kay, George",2,Away
1936-09-05,1936,Charlton Athletic,Liverpool,1-1,1,1,1,1,2,0,D,"Kay, George",1,Away
1936-09-09,1936,Liverpool,Portsmouth,0-0,0,0,1,1,0,0,D,"Kay, George",0,Anfield
1936-09-12,1936,Liverpool,Grimsby Town,7-1,7,1,1,1,8,6,H,"Kay, George",7,Anfield
1936-09-16,1936,Chelsea,Liverpool,2-0,2,0,1,1,2,2,H,"Kay, George",0,Away
1936-09-19,1936,Everton,Liverpool,2-0,2,0,1,1,2,2,H,"Kay, George",0,Away
1936-09-26,1936,Leeds United,Liverpool,2-0,2,0,1,1,2,2,H,"Kay, George",0,Away
1936-10-03,1936,Liverpool,Birmingham City,2-0,2,0,1,1,2,2,H,"Kay, George",2,Anfield
1936-10-10,1936,Middlesbrough,Liverpool,3-3,3,3,1,1,6,0,D,"Kay, George",3,Away
1936-10-17,1936,Liverpool,Bolton Wanderers,0-0,0,0,1,1,0,0,D,"Kay, George",0,Anfield
1936-10-24,1936,Brentford,Liverpool,5-2,5,2,1,1,7,3,H,"Kay, George",2,Away
1936-10-31,1936,Liverpool,Arsenal,2-1,2,1,1,1,3,1,H,"Kay, George",2,Anfield
1936-11-07,1936,Preston North End,Liverpool,3-1,3,1,1,1,4,2,H,"Kay, George",1,Away
1936-11-14,1936,Liverpool,Sheffield Wednesday,2-2,2,2,1,1,4,0,D,"Kay, George",2,Anfield
1936-11-21,1936,Manchester United,Liverpool,2-5,2,5,1,1,7,-3,A,"Kay, George",5,Away
1936-11-28,1936,Liverpool,Derby County,3-3,3,3,1,1,6,0,D,"Kay, George",3,Anfield
1936-12-05,1936,Wolverhampton Wanderers,Liverpool,2-0,2,0,1,1,2,2,H,"Kay, George",0,Away
1936-12-12,1936,Liverpool,Sunderland,4-0,4,0,1,1,4,4,H,"Kay, George",4,Anfield
1936-12-19,1936,Huddersfield Town,Liverpool,4-0,4,0,1,1,4,4,H,"Kay, George",0,Away
1936-12-25,1936,West Bromwich Albion,Liverpool,3-1,3,1,1,1,4,2,H,"Kay, George",1,Away
1936-12-26,1936,Stoke City,Liverpool,1-1,1,1,1,1,2,0,D,"Kay, George",1,Away
1936-12-28,1936,Liverpool,West Bromwich Albion,1-2,1,2,1,1,3,-1,A,"Kay, George",1,Anfield
1937-01-02,1936,Liverpool,Charlton Athletic,1-2,1,2,1,1,3,-1,A,"Kay, George",1,Anfield
1937-01-09,1936,Grimsby Town,Liverpool,2-1,2,1,1,1,3,1,H,"Kay, George",1,Away
1937-01-23,1936,Liverpool,Everton,3-2,3,2,1,1,5,1,H,"Kay, George",3,Anfield
1937-01-30,1936,Liverpool,Leeds United,3-0,3,0,1,1,3,3,H,"Kay, George",3,Anfield
1937-02-06,1936,Birmingham City,Liverpool,5-0,5,0,1,1,5,5,H,"Kay, George",0,Away
1937-02-13,1936,Liverpool,Middlesbrough,0-2,0,2,1,1,2,-2,A,"Kay, George",0,Anfield
1937-02-24,1936,Bolton Wanderers,Liverpool,0-1,0,1,1,1,1,-1,A,"Kay, George",1,Away
1937-02-27,1936,Liverpool,Brentford,2-2,2,2,1,1,4,0,D,"Kay, George",2,Anfield
1937-03-10,1936,Arsenal,Liverpool,1-0,1,0,1,1,1,1,H,"Kay, George",0,Away
1937-03-13,1936,Liverpool,Preston North End,1-1,1,1,1,1,2,0,D,"Kay, George",1,Anfield
1937-03-20,1936,Sheffield Wednesday,Liverpool,1-2,1,2,1,1,3,-1,A,"Kay, George",2,Away
1937-03-26,1936,Liverpool,Manchester City,0-5,0,5,1,1,5,-5,A,"Kay, George",0,Anfield
1937-03-27,1936,Liverpool,Manchester United,2-0,2,0,1,1,2,2,H,"Kay, George",2,Anfield
1937-03-29,1936,Manchester City,Liverpool,5-1,5,1,1,1,6,4,H,"Kay, George",1,Away
1937-04-03,1936,Derby County,Liverpool,4-1,4,1,1,1,5,3,H,"Kay, George",1,Away
1937-04-10,1936,Liverpool,Wolverhampton Wanderers,1-0,1,0,1,1,1,1,H,"Kay, George",1,Anfield
1937-04-17,1936,Sunderland,Liverpool,4-2,4,2,1,1,6,2,H,"Kay, George",2,Away
1937-04-24,1936,Liverpool,Huddersfield Town,1-1,1,1,1,1,2,0,D,"Kay, George",1,Anfield
1937-05-01,1936,Liverpool,Chelsea,1-1,1,1,1,1,2,0,D,"Kay, George",1,Anfield
1937-08-28,1937,Chelsea,Liverpool,6-1,6,1,1,1,7,5,H,"Kay, George",1,Away
1937-09-01,1937,Liverpool,Portsmouth,3-2,3,2,1,1,5,1,H,"Kay, George",3,Anfield
1937-09-04,1937,Liverpool,Charlton Athletic,1-2,1,2,1,1,3,-1,A,"Kay, George",1,Anfield
1937-09-08,1937,Portsmouth,Liverpool,1-1,1,1,1,1,2,0,D,"Kay, George",1,Away
1937-09-11,1937,Preston North End,Liverpool,4-1,4,1,1,1,5,3,H,"Kay, George",1,Away
1937-09-15,1937,Liverpool,Stoke City,3-0,3,0,1,1,3,3,H,"Kay, George",3,Anfield
1937-09-18,1937,Liverpool,Grimsby Town,2-1,2,1,1,1,3,1,H,"Kay, George",2,Anfield
1937-09-25,1937,Leeds United,Liverpool,2-0,2,0,1,1,2,2,H,"Kay, George",0,Away
1937-10-02,1937,Liverpool,Everton,1-2,1,2,1,1,3,-1,A,"Kay, George",1,Anfield
1937-10-09,1937,Liverpool,West Bromwich Albion,0-1,0,1,1,1,1,-1,A,"Kay, George",0,Anfield
1937-10-16,1937,Wolverhampton Wanderers,Liverpool,2-0,2,0,1,1,2,2,H,"Kay, George",0,Away
1937-10-23,1937,Liverpool,Leicester City,1-1,1,1,1,1,2,0,D,"Kay, George",1,Anfield
1937-10-30,1937,Sunderland,Liverpool,2-3,2,3,1,1,5,-1,A,"Kay, George",3,Away
1937-11-06,1937,Liverpool,Brentford,3-4,3,4,1,1,7,-1,A,"Kay, George",3,Anfield
1937-11-13,1937,Manchester City,Liverpool,1-3,1,3,1,1,4,-2,A,"Kay, George",3,Away
1937-11-20,1937,Liverpool,Huddersfield Town,0-1,0,1,1,1,1,-1,A,"Kay, George",0,Anfield
1937-11-27,1937,Blackpool,Liverpool,0-1,0,1,1,1,1,-1,A,"Kay, George",1,Away
1937-12-04,1937,Liverpool,Derby County,3-4,3,4,1,1,7,-1,A,"Kay, George",3,Anfield
1937-12-11,1937,Bolton Wanderers,Liverpool,0-0,0,0,1,1,0,0,D,"Kay, George",0,Away
1937-12-18,1937,Liverpool,Arsenal,2-0,2,0,1,1,2,2,H,"Kay, George",2,Anfield
1937-12-27,1937,Birmingham City,Liverpool,2-2,2,2,1,1,4,0,D,"Kay, George",2,Away
1938-01-01,1937,Liverpool,Chelsea,2-2,2,2,1,1,4,0,D,"Kay, George",2,Anfield
1938-01-15,1937,Charlton Athletic,Liverpool,3-0,3,0,1,1,3,3,H,"Kay, George",0,Away
1938-01-29,1937,Grimsby Town,Liverpool,0-0,0,0,1,1,0,0,D,"Kay, George",0,Away
1938-02-02,1937,Liverpool,Preston North End,2-2,2,2,1,1,4,0,D,"Kay, George",2,Anfield
1938-02-05,1937,Liverpool,Leeds United,1-1,1,1,1,1,2,0,D,"Kay, George",1,Anfield
1938-02-16,1937,Everton,Liverpool,1-3,1,3,1,1,4,-2,A,"Kay, George",3,Away
1938-02-19,1937,West Bromwich Albion,Liverpool,5-1,5,1,1,1,6,4,H,"Kay, George",1,Away
1938-02-26,1937,Liverpool,Wolverhampton Wanderers,0-1,0,1,1,1,1,-1,A,"Kay, George",0,Anfield
1938-03-05,1937,Leicester City,Liverpool,2-2,2,2,1,1,4,0,D,"Kay, George",2,Away
1938-03-12,1937,Liverpool,Sunderland,4-0,4,0,1,1,4,4,H,"Kay, George",4,Anfield
1938-03-19,1937,Brentford,Liverpool,1-3,1,3,1,1,4,-2,A,"Kay, George",3,Away
1938-03-26,1937,Liverpool,Manchester City,2-0,2,0,1,1,2,2,H,"Kay, George",2,Anfield
1938-04-02,1937,Huddersfield Town,Liverpool,1-2,1,2,1,1,3,-1,A,"Kay, George",2,Away
1938-04-06,1937,Liverpool,Birmingham City,3-2,3,2,1,1,5,1,H,"Kay, George",3,Anfield
1938-04-09,1937,Liverpool,Blackpool,4-2,4,2,1,1,6,2,H,"Kay, George",4,Anfield
1938-04-15,1937,Middlesbrough,Liverpool,1-1,1,1,1,1,2,0,D,"Kay, George",1,Away
1938-04-16,1937,Derby County,Liverpool,4-1,4,1,1,1,5,3,H,"Kay, George",1,Away
1938-04-18,1937,Liverpool,Middlesbrough,1-1,1,1,1,1,2,0,D,"Kay, George",1,Anfield
1938-04-23,1937,Liverpool,Bolton Wanderers,2-1,2,1,1,1,3,1,H,"Kay, George",2,Anfield
1938-04-30,1937,Arsenal,Liverpool,1-0,1,0,1,1,1,1,H,"Kay, George",0,Away
1938-05-07,1937,Stoke City,Liverpool,2-0,2,0,1,1,2,2,H,"Kay, George",0,Away
1938-08-27,1938,Liverpool,Chelsea,2-1,2,1,1,1,3,1,H,"Kay, George",2,Anfield
1938-09-03,1938,Preston North End,Liverpool,1-0,1,0,1,1,1,1,H,"Kay, George",0,Away
1938-09-07,1938,Liverpool,Manchester United,1-0,1,0,1,1,1,1,H,"Kay, George",1,Anfield
1938-09-10,1938,Liverpool,Charlton Athletic,1-0,1,0,1,1,1,1,H,"Kay, George",1,Anfield
1938-09-14,1938,Liverpool,Middlesbrough,3-1,3,1,1,1,4,2,H,"Kay, George",3,Anfield
1938-09-17,1938,Bolton Wanderers,Liverpool,3-1,3,1,1,1,4,2,H,"Kay, George",1,Away
1938-09-24,1938,Liverpool,Leeds United,3-0,3,0,1,1,3,3,H,"Kay, George",3,Anfield
1938-10-01,1938,Everton,Liverpool,2-1,2,1,1,1,3,1,H,"Kay, George",1,Away
1938-10-08,1938,Leicester City,Liverpool,2-2,2,2,1,1,4,0,D,"Kay, George",2,Away
1938-10-15,1938,Liverpool,Aston Villa,3-0,3,0,1,1,3,3,H,"Kay, George",3,Anfield
1938-10-22,1938,Wolverhampton Wanderers,Liverpool,2-2,2,2,1,1,4,0,D,"Kay, George",2,Away
1938-10-29,1938,Liverpool,Huddersfield Town,3-3,3,3,1,1,6,0,D,"Kay, George",3,Anfield
1938-11-05,1938,Portsmouth,Liverpool,1-1,1,1,1,1,2,0,D,"Kay, George",1,Away
1938-11-12,1938,Liverpool,Arsenal,2-2,2,2,1,1,4,0,D,"Kay, George",2,Anfield
1938-11-19,1938,Brentford,Liverpool,2-1,2,1,1,1,3,1,H,"Kay, George",1,Away
1938-11-26,1938,Liverpool,Blackpool,1-0,1,0,1,1,1,1,H,"Kay, George",1,Anfield
1938-12-03,1938,Derby County,Liverpool,2-2,2,2,1,1,4,0,D,"Kay, George",2,Away
1938-12-10,1938,Liverpool,Grimsby Town,2-2,2,2,1,1,4,0,D,"Kay, George",2,Anfield
1938-12-17,1938,Sunderland,Liverpool,2-3,2,3,1,1,5,-1,A,"Kay, George",3,Away
1938-12-24,1938,Chelsea,Liverpool,4-1,4,1,1,1,5,3,H,"Kay, George",1,Away
1938-12-26,1938,Stoke City,Liverpool,3-1,3,1,1,1,4,2,H,"Kay, George",1,Away
1938-12-27,1938,Liverpool,Stoke City,1-0,1,0,1,1,1,1,H,"Kay, George",1,Anfield
1938-12-31,1938,Liverpool,Preston North End,4-1,4,1,1,1,5,3,H,"Kay, George",4,Anfield
1939-01-02,1938,Middlesbrough,Liverpool,3-0,3,0,1,1,3,3,H,"Kay, George",0,Away
1939-01-14,1938,Charlton Athletic,Liverpool,1-3,1,3,1,1,4,-2,A,"Kay, George",3,Away
1939-01-25,1938,Liverpool,Bolton Wanderers,1-2,1,2,1,1,3,-1,A,"Kay, George",1,Anfield
1939-01-28,1938,Leeds United,Liverpool,1-1,1,1,1,1,2,0,D,"Kay, George",1,Away
1939-02-04,1938,Liverpool,Everton,0-3,0,3,1,1,3,-3,A,"Kay, George",0,Anfield
1939-02-18,1938,Aston Villa,Liverpool,2-0,2,0,1,1,2,2,H,"Kay, George",0,Away
1939-02-25,1938,Liverpool,Wolverhampton Wanderers,0-2,0,2,1,1,2,-2,A,"Kay, George",0,Anfield
1939-03-04,1938,Liverpool,Leicester City,1-1,1,1,1,1,2,0,D,"Kay, George",1,Anfield
1939-03-11,1938,Liverpool,Portsmouth,4-4,4,4,1,1,8,0,D,"Kay, George",4,Anfield
1939-03-15,1938,Huddersfield Town,Liverpool,1-1,1,1,1,1,2,0,D,"Kay, George",1,Away
1939-03-18,1938,Arsenal,Liverpool,2-0,2,0,1,1,2,2,H,"Kay, George",0,Away
1939-03-25,1938,Liverpool,Brentford,1-0,1,0,1,1,1,1,H,"Kay, George",1,Anfield
1939-04-01,1938,Blackpool,Liverpool,1-1,1,1,1,1,2,0,D,"Kay, George",1,Away
1939-04-07,1938,Liverpool,Birmingham City,4-0,4,0,1,1,4,4,H,"Kay, George",4,Anfield
1939-04-08,1938,Liverpool,Derby County,2-1,2,1,1,1,3,1,H,"Kay, George",2,Anfield
1939-04-10,1938,Birmingham City,Liverpool,0-0,0,0,1,1,0,0,D,"Kay, George",0,Away
1939-04-15,1938,Grimsby Town,Liverpool,2-1,2,1,1,1,3,1,H,"Kay, George",1,Away
1939-04-22,1938,Liverpool,Sunderland,1-1,1,1,1,1,2,0,D,"Kay, George",1,Anfield
1939-05-06,1938,Manchester United,Liverpool,2-0,2,0,1,1,2,2,H,"Kay, George",0,Away
1946-08-31,1946,Sheffield United,Liverpool,0-1,0,1,1,1,1,-1,A,"Kay, George",1,Away
1946-09-04,1946,Liverpool,Middlesbrough,0-1,0,1,1,1,1,-1,A,"Kay, George",0,Anfield
1946-09-07,1946,Liverpool,Chelsea,7-4,7,4,1,1,11,3,H,"Kay, George",7,Anfield
1946-09-11,1946,Manchester United,Liverpool,5-0,5,0,1,1,5,5,H,"Kay, George",0,Away
1946-09-14,1946,Bolton Wanderers,Liverpool,1-3,1,3,1,1,4,-2,A,"Kay, George",3,Away
1946-09-21,1946,Liverpool,Everton,0-0,0,0,1,1,0,0,D,"Kay, George",0,Anfield
1946-09-28,1946,Liverpool,Leeds United,2-0,2,0,1,1,2,2,H,"Kay, George",2,Anfield
1946-10-05,1946,Grimsby Town,Liverpool,1-6,1,6,1,1,7,-5,A,"Kay, George",6,Away
1946-10-09,1946,Middlesbrough,Liverpool,2-2,2,2,1,1,4,0,D,"Kay, George",2,Away
1946-10-12,1946,Liverpool,Charlton Athletic,1-1,1,1,1,1,2,0,D,"Kay, George",1,Anfield
1946-10-19,1946,Huddersfield Town,Liverpool,1-4,1,4,1,1,5,-3,A,"Kay, George",4,Away
1946-10-26,1946,Liverpool,Brentford,1-0,1,0,1,1,1,1,H,"Kay, George",1,Anfield
1946-11-02,1946,Blackburn Rovers,Liverpool,0-0,0,0,1,1,0,0,D,"Kay, George",0,Away
1946-11-09,1946,Liverpool,Portsmouth,3-0,3,0,1,1,3,3,H,"Kay, George",3,Anfield
1946-11-16,1946,Derby County,Liverpool,1-4,1,4,1,1,5,-3,A,"Kay, George",4,Away
1946-11-23,1946,Liverpool,Arsenal,4-2,4,2,1,1,6,2,H,"Kay, George",4,Anfield
1946-11-30,1946,Blackpool,Liverpool,3-2,3,2,1,1,5,1,H,"Kay, George",2,Away
1946-12-07,1946,Liverpool,Wolverhampton Wanderers,1-5,1,5,1,1,6,-4,A,"Kay, George",1,Anfield
1946-12-14,1946,Sunderland,Liverpool,1-4,1,4,1,1,5,-3,A,"Kay, George",4,Away
1946-12-21,1946,Liverpool,Aston Villa,4-1,4,1,1,1,5,3,H,"Kay, George",4,Anfield
1946-12-25,1946,Stoke City,Liverpool,2-1,2,1,1,1,3,1,H,"Kay, George",1,Away
1946-12-26,1946,Liverpool,Stoke City,2-0,2,0,1,1,2,2,H,"Kay, George",2,Anfield
1946-12-28,1946,Liverpool,Sheffield United,1-2,1,2,1,1,3,-1,A,"Kay, George",1,Anfield
1947-01-04,1946,Chelsea,Liverpool,3-1,3,1,1,1,4,2,H,"Kay, George",1,Away
1947-01-18,1946,Liverpool,Bolton Wanderers,0-3,0,3,1,1,3,-3,A,"Kay, George",0,Anfield
1947-01-29,1946,Everton,Liverpool,1-0,1,0,1,1,1,1,H,"Kay, George",0,Away
1947-02-01,1946,Leeds United,Liverpool,1-2,1,2,1,1,3,-1,A,"Kay, George",2,Away
1947-02-12,1946,Liverpool,Grimsby Town,5-0,5,0,1,1,5,5,H,"Kay, George",5,Anfield
1947-02-22,1946,Liverpool,Huddersfield Town,1-0,1,0,1,1,1,1,H,"Kay, George",1,Anfield
1947-03-08,1946,Liverpool,Blackburn Rovers,2-1,2,1,1,1,3,1,H,"Kay, George",2,Anfield
1947-03-15,1946,Portsmouth,Liverpool,1-2,1,2,1,1,3,-1,A,"Kay, George",2,Away
1947-03-22,1946,Liverpool,Derby County,1-1,1,1,1,1,2,0,D,"Kay, George",1,Anfield
1947-04-04,1946,Preston North End,Liverpool,0-0,0,0,1,1,0,0,D,"Kay, George",0,Away
1947-04-05,1946,Liverpool,Blackpool,2-3,2,3,1,1,5,-1,A,"Kay, George",2,Anfield
1947-04-07,1946,Liverpool,Preston North End,3-0,3,0,1,1,3,3,H,"Kay, George",3,Anfield
1947-04-19,1946,Liverpool,Sunderland,1-0,1,0,1,1,1,1,H,"Kay, George",1,Anfield
1947-04-26,1946,Aston Villa,Liverpool,1-2,1,2,1,1,3,-1,A,"Kay, George",2,Away
1947-05-03,1946,Liverpool,Manchester United,1-0,1,0,1,1,1,1,H,"Kay, George",1,Anfield
1947-05-10,1946,Charlton Athletic,Liverpool,1-3,1,3,1,1,4,-2,A,"Kay, George",3,Away
1947-05-17,1946,Brentford,Liverpool,1-1,1,1,1,1,2,0,D,"Kay, George",1,Away
1947-05-24,1946,Arsenal,Liverpool,1-2,1,2,1,1,3,-1,A,"Kay, George",2,Away
1947-05-31,1946,Wolverhampton Wanderers,Liverpool,1-2,1,2,1,1,3,-1,A,"Kay, George",2,Away
1947-08-23,1947,Liverpool,Preston North End,3-1,3,1,1,1,4,2,H,"Kay, George",3,Anfield
1947-08-27,1947,Manchester United,Liverpool,2-0,2,0,1,1,2,2,H,"Kay, George",0,Away
1947-08-30,1947,Stoke City,Liverpool,0-2,0,2,1,1,2,-2,A,"Kay, George",2,Away
1947-09-03,1947,Liverpool,Manchester United,2-2,2,2,1,1,4,0,D,"Kay, George",2,Anfield
1947-09-06,1947,Liverpool,Burnley,1-1,1,1,1,1,2,0,D,"Kay, George",1,Anfield
1947-09-08,1947,Sheffield United,Liverpool,3-1,3,1,1,1,4,2,H,"Kay, George",1,Away
1947-09-13,1947,Portsmouth,Liverpool,1-0,1,0,1,1,1,1,H,"Kay, George",0,Away
1947-09-17,1947,Charlton Athletic,Liverpool,2-0,2,0,1,1,2,2,H,"Kay, George",0,Away
1947-09-20,1947,Liverpool,Bolton Wanderers,0-0,0,0,1,1,0,0,D,"Kay, George",0,Anfield
1947-09-27,1947,Everton,Liverpool,0-3,0,3,1,1,3,-3,A,"Kay, George",3,Away
1947-10-04,1947,Middlesbrough,Liverpool,3-1,3,1,1,1,4,2,H,"Kay, George",1,Away
1947-10-11,1947,Liverpool,Chelsea,3-0,3,0,1,1,3,3,H,"Kay, George",3,Anfield
1947-10-18,1947,Huddersfield Town,Liverpool,1-1,1,1,1,1,2,0,D,"Kay, George",1,Away
1947-10-25,1947,Liverpool,Derby County,2-2,2,2,1,1,4,0,D,"Kay, George",2,Anfield
1947-11-01,1947,Blackpool,Liverpool,2-0,2,0,1,1,2,2,H,"Kay, George",0,Away
1947-11-08,1947,Liverpool,Grimsby Town,3-1,3,1,1,1,4,2,H,"Kay, George",3,Anfield
1947-11-15,1947,Sunderland,Liverpool,5-1,5,1,1,1,6,4,H,"Kay, George",1,Away
1947-11-22,1947,Liverpool,Blackburn Rovers,2-1,2,1,1,1,3,1,H,"Kay, George",2,Anfield
1947-11-29,1947,Manchester City,Liverpool,2-0,2,0,1,1,2,2,H,"Kay, George",0,Away
1947-12-06,1947,Liverpool,Aston Villa,3-3,3,3,1,1,6,0,D,"Kay, George",3,Anfield
1947-12-13,1947,Wolverhampton Wanderers,Liverpool,1-2,1,2,1,1,3,-1,A,"Kay, George",2,Away
1947-12-20,1947,Preston North End,Liverpool,3-3,3,3,1,1,6,0,D,"Kay, George",3,Away
1947-12-25,1947,Liverpool,Arsenal,1-3,1,3,1,1,4,-2,A,"Kay, George",1,Anfield
1947-12-27,1947,Arsenal,Liverpool,1-2,1,2,1,1,3,-1,A,"Kay, George",2,Away
1948-01-01,1947,Liverpool,Charlton Athletic,2-3,2,3,1,1,5,-1,A,"Kay, George",2,Anfield
1948-01-03,1947,Liverpool,Stoke City,0-0,0,0,1,1,0,0,D,"Kay, George",0,Anfield
1948-01-17,1947,Burnley,Liverpool,3-0,3,0,1,1,3,3,H,"Kay, George",0,Away
1948-01-31,1947,Liverpool,Portsmouth,0-3,0,3,1,1,3,-3,A,"Kay, George",0,Anfield
1948-02-07,1947,Bolton Wanderers,Liverpool,3-0,3,0,1,1,3,3,H,"Kay, George",0,Away
1948-02-21,1947,Liverpool,Middlesbrough,0-1,0,1,1,1,1,-1,A,"Kay, George",0,Anfield
1948-02-28,1947,Chelsea,Liverpool,3-1,3,1,1,1,4,2,H,"Kay, George",1,Away
1948-03-06,1947,Liverpool,Huddersfield Town,4-0,4,0,1,1,4,4,H,"Kay, George",4,Anfield
1948-03-20,1947,Liverpool,Blackpool,2-0,2,0,1,1,2,2,H,"Kay, George",2,Anfield
1948-03-26,1947,Liverpool,Sheffield United,4-0,4,0,1,1,4,4,H,"Kay, George",4,Anfield
1948-03-27,1947,Grimsby Town,Liverpool,0-2,0,2,1,1,2,-2,A,"Kay, George",2,Away
1948-03-31,1947,Derby County,Liverpool,0-4,0,4,1,1,4,-4,A,"Kay, George",4,Away
1948-04-03,1947,Liverpool,Sunderland,0-0,0,0,1,1,0,0,D,"Kay, George",0,Anfield
1948-04-10,1947,Blackburn Rovers,Liverpool,1-2,1,2,1,1,3,-1,A,"Kay, George",2,Away
1948-04-17,1947,Liverpool,Manchester City,1-1,1,1,1,1,2,0,D,"Kay, George",1,Anfield
1948-04-21,1947,Liverpool,Everton,4-0,4,0,1,1,4,4,H,"Kay, George",4,Anfield
1948-04-24,1947,Aston Villa,Liverpool,2-1,2,1,1,1,3,1,H,"Kay, George",1,Away
1948-05-01,1947,Liverpool,Wolverhampton Wanderers,2-1,2,1,1,1,3,1,H,"Kay, George",2,Anfield
1948-08-21,1948,Aston Villa,Liverpool,2-1,2,1,1,1,3,1,H,"Kay, George",1,Away
1948-08-25,1948,Liverpool,Sheffield United,3-3,3,3,1,1,6,0,D,"Kay, George",3,Anfield
1948-08-28,1948,Liverpool,Sunderland,4-0,4,0,1,1,4,4,H,"Kay, George",4,Anfield
1948-08-30,1948,Sheffield United,Liverpool,1-2,1,2,1,1,3,-1,A,"Kay, George",2,Away
1948-09-04,1948,Wolverhampton Wanderers,Liverpool,0-0,0,0,1,1,0,0,D,"Kay, George",0,Away
1948-09-08,1948,Arsenal,Liverpool,1-1,1,1,1,1,2,0,D,"Kay, George",1,Away
1948-09-11,1948,Liverpool,Bolton Wanderers,0-1,0,1,1,1,1,-1,A,"Kay, George",0,Anfield
1948-09-15,1948,Liverpool,Arsenal,0-1,0,1,1,1,1,-1,A,"Kay, George",0,Anfield
1948-09-18,1948,Everton,Liverpool,1-1,1,1,1,1,2,0,D,"Kay, George",1,Away
1948-09-25,1948,Blackpool,Liverpool,1-0,1,0,1,1,1,1,H,"Kay, George",0,Away
1948-10-02,1948,Liverpool,Derby County,0-0,0,0,1,1,0,0,D,"Kay, George",0,Anfield
1948-10-09,1948,Liverpool,Chelsea,1-1,1,1,1,1,2,0,D,"Kay, George",1,Anfield
1948-10-16,1948,Birmingham City,Liverpool,0-1,0,1,1,1,1,-1,A,"Kay, George",1,Away
1948-10-23,1948,Liverpool,Middlesbrough,4-0,4,0,1,1,4,4,H,"Kay, George",4,Anfield
1948-10-30,1948,Newcastle United,Liverpool,1-0,1,0,1,1,1,1,H,"Kay, George",0,Away
1948-11-06,1948,Liverpool,Portsmouth,3-1,3,1,1,1,4,2,H,"Kay, George",3,Anfield
1948-11-13,1948,Manchester City,Liverpool,2-4,2,4,1,1,6,-2,A,"Kay, George",4,Away
1948-11-20,1948,Liverpool,Charlton Athletic,1-1,1,1,1,1,2,0,D,"Kay, George",1,Anfield
1948-11-27,1948,Stoke City,Liverpool,3-0,3,0,1,1,3,3,H,"Kay, George",0,Away
1948-12-04,1948,Liverpool,Burnley,1-1,1,1,1,1,2,0,D,"Kay, George",1,Anfield
1948-12-11,1948,Preston North End,Liverpool,3-2,3,2,1,1,5,1,H,"Kay, George",2,Away
1948-12-18,1948,Liverpool,Aston Villa,1-1,1,1,1,1,2,0,D,"Kay, George",1,Anfield
1948-12-25,1948,Manchester United,Liverpool,0-0,0,0,1,1,0,0,D,"Kay, George",0,Away
1948-12-27,1948,Liverpool,Manchester United,0-2,0,2,1,1,2,-2,A,"Kay, George",0,Anfield
1949-01-01,1948,Sunderland,Liverpool,0-2,0,2,1,1,2,-2,A,"Kay, George",2,Away
1949-01-22,1948,Bolton Wanderers,Liverpool,0-3,0,3,1,1,3,-3,A,"Kay, George",3,Away
1949-02-05,1948,Liverpool,Everton,0-0,0,0,1,1,0,0,D,"Kay, George",0,Anfield
1949-02-19,1948,Liverpool,Blackpool,1-1,1,1,1,1,2,0,D,"Kay, George",1,Anfield
1949-03-05,1948,Chelsea,Liverpool,2-1,2,1,1,1,3,1,H,"Kay, George",1,Away
1949-03-12,1948,Liverpool,Birmingham City,1-0,1,0,1,1,1,1,H,"Kay, George",1,Anfield
1949-03-19,1948,Charlton Athletic,Liverpool,2-1,2,1,1,1,3,1,H,"Kay, George",1,Away
1949-03-26,1948,Liverpool,Stoke City,4-0,4,0,1,1,4,4,H,"Kay, George",4,Anfield
1949-04-02,1948,Portsmouth,Liverpool,3-2,3,2,1,1,5,1,H,"Kay, George",2,Away
1949-04-06,1948,Liverpool,Wolverhampton Wanderers,0-0,0,0,1,1,0,0,D,"Kay, George",0,Anfield
1949-04-09,1948,Liverpool,Manchester City,0-1,0,1,1,1,1,-1,A,"Kay, George",0,Anfield
1949-04-15,1948,Liverpool,Huddersfield Town,0-1,0,1,1,1,1,-1,A,"Kay, George",0,Anfield
1949-04-16,1948,Middlesbrough,Liverpool,0-1,0,1,1,1,1,-1,A,"Kay, George",1,Away
1949-04-18,1948,Huddersfield Town,Liverpool,0-4,0,4,1,1,4,-4,A,"Kay, George",4,Away
1949-04-23,1948,Liverpool,Newcastle United,1-1,1,1,1,1,2,0,D,"Kay, George",1,Anfield
1949-04-30,1948,Burnley,Liverpool,0-2,0,2,1,1,2,-2,A,"Kay, George",2,Away
1949-05-04,1948,Derby County,Liverpool,3-0,3,0,1,1,3,3,H,"Kay, George",0,Away
1949-05-07,1948,Liverpool,Preston North End,0-2,0,2,1,1,2,-2,A,"Kay, George",0,Anfield
1949-08-20,1949,Liverpool,Sunderland,4-2,4,2,1,1,6,2,H,"Kay, George",4,Anfield
1949-08-22,1949,Stoke City,Liverpool,0-0,0,0,1,1,0,0,D,"Kay, George",0,Away
1949-08-27,1949,Everton,Liverpool,0-0,0,0,1,1,0,0,D,"Kay, George",0,Away
1949-08-31,1949,Liverpool,Stoke City,1-1,1,1,1,1,2,0,D,"Kay, George",1,Anfield
1949-09-03,1949,Arsenal,Liverpool,1-2,1,2,1,1,3,-1,A,"Kay, George",2,Away
1949-09-07,1949,Liverpool,Manchester United,1-1,1,1,1,1,2,0,D,"Kay, George",1,Anfield
1949-09-10,1949,Liverpool,Bolton Wanderers,1-1,1,1,1,1,2,0,D,"Kay, George",1,Anfield
1949-09-17,1949,Birmingham City,Liverpool,2-3,2,3,1,1,5,-1,A,"Kay, George",3,Away
1949-09-24,1949,Liverpool,Derby County,3-1,3,1,1,1,4,2,H,"Kay, George",3,Anfield
1949-10-01,1949,West Bromwich Albion,Liverpool,0-1,0,1,1,1,1,-1,A,"Kay, George",1,Away
1949-10-08,1949,Liverpool,Middlesbrough,2-0,2,0,1,1,2,2,H,"Kay, George",2,Anfield
1949-10-15,1949,Blackpool,Liverpool,0-0,0,0,1,1,0,0,D,"Kay, George",0,Away
1949-10-22,1949,Liverpool,Newcastle United,2-2,2,2,1,1,4,0,D,"Kay, George",2,Anfield
1949-10-29,1949,Fulham,Liverpool,0-1,0,1,1,1,1,-1,A,"Kay, George",1,Away
1949-11-05,1949,Liverpool,Manchester City,4-0,4,0,1,1,4,4,H,"Kay, George",4,Anfield
1949-11-12,1949,Charlton Athletic,Liverpool,1-3,1,3,1,1,4,-2,A,"Kay, George",3,Away
1949-11-19,1949,Liverpool,Aston Villa,2-1,2,1,1,1,3,1,H,"Kay, George",2,Anfield
1949-11-26,1949,Wolverhampton Wanderers,Liverpool,1-1,1,1,1,1,2,0,D,"Kay, George",1,Away
1949-12-03,1949,Liverpool,Portsmouth,2-2,2,2,1,1,4,0,D,"Kay, George",2,Anfield
1949-12-10,1949,Huddersfield Town,Liverpool,3-2,3,2,1,1,5,1,H,"Kay, George",2,Away
1949-12-17,1949,Sunderland,Liverpool,3-2,3,2,1,1,5,1,H,"Kay, George",2,Away
1949-12-24,1949,Liverpool,Everton,3-1,3,1,1,1,4,2,H,"Kay, George",3,Anfield
1949-12-26,1949,Chelsea,Liverpool,1-1,1,1,1,1,2,0,D,"Kay, George",1,Away
1949-12-27,1949,Liverpool,Chelsea,2-2,2,2,1,1,4,0,D,"Kay, George",2,Anfield
1949-12-31,1949,Liverpool,Arsenal,2-0,2,0,1,1,2,2,H,"Kay, George",2,Anfield
1950-01-14,1949,Bolton Wanderers,Liverpool,3-2,3,2,1,1,5,1,H,"Kay, George",2,Away
1950-01-21,1949,Liverpool,Birmingham City,2-0,2,0,1,1,2,2,H,"Kay, George",2,Anfield
1950-02-04,1949,Derby County,Liverpool,2-2,2,2,1,1,4,0,D,"Kay, George",2,Away
1950-02-18,1949,Liverpool,West Bromwich Albion,2-1,2,1,1,1,3,1,H,"Kay, George",2,Anfield
1950-02-25,1949,Middlesbrough,Liverpool,4-1,4,1,1,1,5,3,H,"Kay, George",1,Away
1950-03-08,1949,Liverpool,Blackpool,0-1,0,1,1,1,1,-1,A,"Kay, George",0,Anfield
1950-03-11,1949,Aston Villa,Liverpool,2-0,2,0,1,1,2,2,H,"Kay, George",0,Away
1950-03-15,1949,Manchester United,Liverpool,0-0,0,0,1,1,0,0,D,"Kay, George",0,Away
1950-03-18,1949,Liverpool,Wolverhampton Wanderers,0-2,0,2,1,1,2,-2,A,"Kay, George",0,Anfield
1950-03-29,1949,Manchester City,Liverpool,1-2,1,2,1,1,3,-1,A,"Kay, George",2,Away
1950-04-01,1949,Liverpool,Charlton Athletic,1-0,1,0,1,1,1,1,H,"Kay, George",1,Anfield
1950-04-07,1949,Burnley,Liverpool,0-2,0,2,1,1,2,-2,A,"Kay, George",2,Away
1950-04-08,1949,Newcastle United,Liverpool,5-1,5,1,1,1,6,4,H,"Kay, George",1,Away
1950-04-10,1949,Liverpool,Burnley,0-1,0,1,1,1,1,-1,A,"Kay, George",0,Anfield
1950-04-15,1949,Liverpool,Fulham,1-1,1,1,1,1,2,0,D,"Kay, George",1,Anfield
1950-04-22,1949,Portsmouth,Liverpool,2-1,2,1,1,1,3,1,H,"Kay, George",1,Away
1950-05-03,1949,Liverpool,Huddersfield Town,2-3,2,3,1,1,5,-1,A,"Kay, George",2,Anfield
1950-08-19,1950,Wolverhampton Wanderers,Liverpool,2-0,2,0,1,1,2,2,H,"Kay, George",0,Away
1950-08-23,1950,Liverpool,Manchester United,2-1,2,1,1,1,3,1,H,"Kay, George",2,Anfield
1950-08-26,1950,Liverpool,Sunderland,4-0,4,0,1,1,4,4,H,"Kay, George",4,Anfield
1950-08-30,1950,Manchester United,Liverpool,1-0,1,0,1,1,1,1,H,"Kay, George",0,Away
1950-09-02,1950,Aston Villa,Liverpool,1-1,1,1,1,1,2,0,D,"Kay, George",1,Away
1950-09-06,1950,Liverpool,Tottenham Hotspur,2-1,2,1,1,1,3,1,H,"Kay, George",2,Anfield
1950-09-09,1950,Liverpool,Derby County,1-0,1,0,1,1,1,1,H,"Kay, George",1,Anfield
1950-09-16,1950,Everton,Liverpool,1-3,1,3,1,1,4,-2,A,"Kay, George",3,Away
1950-09-23,1950,Fulham,Liverpool,2-1,2,1,1,1,3,1,H,"Kay, George",1,Away
1950-09-30,1950,Liverpool,Bolton Wanderers,3-3,3,3,1,1,6,0,D,"Kay, George",3,Anfield
1950-10-07,1950,Liverpool,Stoke City,0-0,0,0,1,1,0,0,D,"Kay, George",0,Anfield
1950-10-14,1950,West Bromwich Albion,Liverpool,1-1,1,1,1,1,2,0,D,"Kay, George",1,Away
1950-10-21,1950,Liverpool,Middlesbrough,0-0,0,0,1,1,0,0,D,"Kay, George",0,Anfield
1950-10-28,1950,Sheffield Wednesday,Liverpool,4-1,4,1,1,1,5,3,H,"Kay, George",1,Away
1950-11-04,1950,Liverpool,Newcastle United,2-4,2,4,1,1,6,-2,A,"Kay, George",2,Anfield
1950-11-11,1950,Huddersfield Town,Liverpool,2-2,2,2,1,1,4,0,D,"Kay, George",2,Away
1950-11-18,1950,Liverpool,Arsenal,1-3,1,3,1,1,4,-2,A,"Kay, George",1,Anfield
1950-11-25,1950,Burnley,Liverpool,1-1,1,1,1,1,2,0,D,"Kay, George",1,Away
1950-12-02,1950,Liverpool,Chelsea,1-0,1,0,1,1,1,1,H,"Kay, George",1,Anfield
1950-12-09,1950,Portsmouth,Liverpool,1-3,1,3,1,1,4,-2,A,"Kay, George",3,Away
1950-12-16,1950,Liverpool,Wolverhampton Wanderers,1-4,1,4,1,1,5,-3,A,"Kay, George",1,Anfield
1950-12-23,1950,Sunderland,Liverpool,2-1,2,1,1,1,3,1,H,"Kay, George",1,Away
1950-12-25,1950,Blackpool,Liverpool,3-0,3,0,1,1,3,3,H,"Kay, George",0,Away
1950-12-26,1950,Liverpool,Blackpool,1-0,1,0,1,1,1,1,H,"Kay, George",1,Anfield
1951-01-13,1950,Derby County,Liverpool,1-2,1,2,1,1,3,-1,A,,2,Away
1951-01-20,1950,Liverpool,Everton,0-2,0,2,1,1,2,-2,A,,0,Anfield
1951-01-27,1950,Charlton Athletic,Liverpool,1-0,1,0,1,1,1,1,H,,0,Away
1951-02-03,1950,Liverpool,Fulham,2-0,2,0,1,1,2,2,H,,2,Anfield
1951-02-10,1950,Liverpool,Portsmouth,2-1,2,1,1,1,3,1,H,,2,Anfield
1951-02-17,1950,Bolton Wanderers,Liverpool,2-1,2,1,1,1,3,1,H,,1,Away
1951-02-24,1950,Stoke City,Liverpool,2-3,2,3,1,1,5,-1,A,,3,Away
1951-03-03,1950,Liverpool,West Bromwich Albion,1-1,1,1,1,1,2,0,D,,1,Anfield
1951-03-10,1950,Middlesbrough,Liverpool,1-1,1,1,1,1,2,0,D,,1,Away
1951-03-17,1950,Liverpool,Sheffield Wednesday,2-1,2,1,1,1,3,1,H,,2,Anfield
1951-03-23,1950,Liverpool,Charlton Athletic,1-0,1,0,1,1,1,1,H,"Welsh, Don",1,Anfield
1951-03-24,1950,Newcastle United,Liverpool,1-1,1,1,1,1,2,0,D,"Welsh, Don",1,Away
1951-03-31,1950,Liverpool,Huddersfield Town,1-4,1,4,1,1,5,-3,A,"Welsh, Don",1,Anfield
1951-04-07,1950,Arsenal,Liverpool,1-2,1,2,1,1,3,-1,A,"Welsh, Don",2,Away
1951-04-14,1950,Liverpool,Burnley,1-0,1,0,1,1,1,1,H,"Welsh, Don",1,Anfield
1951-04-21,1950,Chelsea,Liverpool,1-0,1,0,1,1,1,1,H,"Welsh, Don",0,Away
1951-04-25,1950,Liverpool,Aston Villa,0-0,0,0,1,1,0,0,D,"Welsh, Don",0,Anfield
1951-05-05,1950,Tottenham Hotspur,Liverpool,3-1,3,1,1,1,4,2,H,"Welsh, Don",1,Away
1951-08-18,1951,Liverpool,Portsmouth,0-2,0,2,1,1,2,-2,A,"Welsh, Don",0,Anfield
1951-08-21,1951,Burnley,Liverpool,0-0,0,0,1,1,0,0,D,"Welsh, Don",0,Away
1951-08-25,1951,Chelsea,Liverpool,1-3,1,3,1,1,4,-2,A,"Welsh, Don",3,Away
1951-08-29,1951,Liverpool,Burnley,3-1,3,1,1,1,4,2,H,"Welsh, Don",3,Anfield
1951-09-01,1951,Liverpool,Huddersfield Town,2-1,2,1,1,1,3,1,H,"Welsh, Don",2,Anfield
1951-09-05,1951,Arsenal,Liverpool,0-0,0,0,1,1,0,0,D,"Welsh, Don",0,Away
1951-09-08,1951,Wolverhampton Wanderers,Liverpool,2-1,2,1,1,1,3,1,H,"Welsh, Don",1,Away
1951-09-12,1951,Liverpool,Arsenal,0-0,0,0,1,1,0,0,D,"Welsh, Don",0,Anfield
1951-09-15,1951,Liverpool,Sunderland,2-2,2,2,1,1,4,0,D,"Welsh, Don",2,Anfield
1951-09-22,1951,Aston Villa,Liverpool,2-0,2,0,1,1,2,2,H,"Welsh, Don",0,Away
1951-09-29,1951,Liverpool,Derby County,2-0,2,0,1,1,2,2,H,"Welsh, Don",2,Anfield
1951-10-06,1951,Charlton Athletic,Liverpool,2-0,2,0,1,1,2,2,H,"Welsh, Don",0,Away
1951-10-13,1951,Liverpool,Fulham,4-0,4,0,1,1,4,4,H,"Welsh, Don",4,Anfield
1951-10-20,1951,Middlesbrough,Liverpool,3-3,3,3,1,1,6,0,D,"Welsh, Don",3,Away
1951-10-27,1951,Liverpool,West Bromwich Albion,2-5,2,5,1,1,7,-3,A,"Welsh, Don",2,Anfield
1951-11-03,1951,Newcastle United,Liverpool,1-1,1,1,1,1,2,0,D,"Welsh, Don",1,Away
1951-11-10,1951,Liverpool,Bolton Wanderers,1-1,1,1,1,1,2,0,D,"Welsh, Don",1,Anfield
1951-11-17,1951,Stoke City,Liverpool,1-2,1,2,1,1,3,-1,A,"Welsh, Don",2,Away
1951-11-24,1951,Liverpool,Manchester United,0-0,0,0,1,1,0,0,D,"Welsh, Don",0,Anfield
1951-12-01,1951,Tottenham Hotspur,Liverpool,2-3,2,3,1,1,5,-1,A,"Welsh, Don",3,Away
1951-12-08,1951,Liverpool,Preston North End,2-2,2,2,1,1,4,0,D,"Welsh, Don",2,Anfield
1951-12-15,1951,Portsmouth,Liverpool,1-3,1,3,1,1,4,-2,A,"Welsh, Don",3,Away
1951-12-22,1951,Liverpool,Chelsea,1-1,1,1,1,1,2,0,D,"Welsh, Don",1,Anfield
1951-12-25,1951,Liverpool,Blackpool,1-1,1,1,1,1,2,0,D,"Welsh, Don",1,Anfield
1951-12-26,1951,Blackpool,Liverpool,2-0,2,0,1,1,2,2,H,"Welsh, Don",0,Away
1951-12-29,1951,Huddersfield Town,Liverpool,1-2,1,2,1,1,3,-1,A,"Welsh, Don",2,Away
1952-01-05,1951,Liverpool,Wolverhampton Wanderers,1-1,1,1,1,1,2,0,D,"Welsh, Don",1,Anfield
1952-01-19,1951,Sunderland,Liverpool,3-0,3,0,1,1,3,3,H,"Welsh, Don",0,Away
1952-01-26,1951,Liverpool,Aston Villa,1-2,1,2,1,1,3,-1,A,"Welsh, Don",1,Anfield
1952-02-09,1951,Derby County,Liverpool,1-1,1,1,1,1,2,0,D,"Welsh, Don",1,Away
1952-02-16,1951,Liverpool,Charlton Athletic,1-1,1,1,1,1,2,0,D,"Welsh, Don",1,Anfield
1952-03-01,1951,Fulham,Liverpool,1-1,1,1,1,1,2,0,D,"Welsh, Don",1,Away
1952-03-08,1951,Liverpool,Middlesbrough,1-1,1,1,1,1,2,0,D,"Welsh, Don",1,Anfield
1952-03-15,1951,West Bromwich Albion,Liverpool,3-3,3,3,1,1,6,0,D,"Welsh, Don",3,Away
1952-03-22,1951,Liverpool,Newcastle United,3-0,3,0,1,1,3,3,H,"Welsh, Don",3,Anfield
1952-03-29,1951,Bolton Wanderers,Liverpool,1-1,1,1,1,1,2,0,D,"Welsh, Don",1,Away
1952-04-05,1951,Liverpool,Stoke City,2-1,2,1,1,1,3,1,H,"Welsh, Don",2,Anfield
1952-04-11,1951,Manchester City,Liverpool,1-2,1,2,1,1,3,-1,A,"Welsh, Don",2,Away
1952-04-12,1951,Manchester United,Liverpool,4-0,4,0,1,1,4,4,H,"Welsh, Don",0,Away
1952-04-14,1951,Liverpool,Manchester City,1-2,1,2,1,1,3,-1,A,"Welsh, Don",1,Anfield
1952-04-19,1951,Liverpool,Tottenham Hotspur,1-1,1,1,1,1,2,0,D,"Welsh, Don",1,Anfield
1952-04-26,1951,Preston North End,Liverpool,4-0,4,0,1,1,4,4,H,"Welsh, Don",0,Away
1952-08-23,1952,Preston North End,Liverpool,1-1,1,1,1,1,2,0,D,"Welsh, Don",1,Away
1952-08-27,1952,Liverpool,Sheffield Wednesday,1-0,1,0,1,1,1,1,H,"Welsh, Don",1,Anfield
1952-08-30,1952,Liverpool,Stoke City,3-2,3,2,1,1,5,1,H,"Welsh, Don",3,Anfield
1952-09-03,1952,Sheffield Wednesday,Liverpool,0-2,0,2,1,1,2,-2,A,"Welsh, Don",2,Away
1952-09-06,1952,Manchester City,Liverpool,0-2,0,2,1,1,2,-2,A,"Welsh, Don",2,Away
1952-09-10,1952,Liverpool,Tottenham Hotspur,2-1,2,1,1,1,3,1,H,"Welsh, Don",2,Anfield
1952-09-13,1952,Liverpool,Portsmouth,1-1,1,1,1,1,2,0,D,"Welsh, Don",1,Anfield
1952-09-15,1952,Tottenham Hotspur,Liverpool,3-1,3,1,1,1,4,2,H,"Welsh, Don",1,Away
1952-09-20,1952,Liverpool,Middlesbrough,4-1,4,1,1,1,5,3,H,"Welsh, Don",4,Anfield
1952-09-27,1952,West Bromwich Albion,Liverpool,3-0,3,0,1,1,3,3,H,"Welsh, Don",0,Away
1952-10-04,1952,Liverpool,Newcastle United,5-3,5,3,1,1,8,2,H,"Welsh, Don",5,Anfield
1952-10-11,1952,Bolton Wanderers,Liverpool,2-2,2,2,1,1,4,0,D,"Welsh, Don",2,Away
1952-10-18,1952,Liverpool,Aston Villa,0-2,0,2,1,1,2,-2,A,"Welsh, Don",0,Anfield
1952-10-25,1952,Sunderland,Liverpool,3-1,3,1,1,1,4,2,H,"Welsh, Don",1,Away
1952-11-01,1952,Liverpool,Wolverhampton Wanderers,2-1,2,1,1,1,3,1,H,"Welsh, Don",2,Anfield
1952-11-08,1952,Charlton Athletic,Liverpool,3-2,3,2,1,1,5,1,H,"Welsh, Don",2,Away
1952-11-15,1952,Liverpool,Arsenal,1-5,1,5,1,1,6,-4,A,"Welsh, Don",1,Anfield
1952-11-22,1952,Derby County,Liverpool,3-2,3,2,1,1,5,1,H,"Welsh, Don",2,Away
1952-11-29,1952,Liverpool,Blackpool,2-2,2,2,1,1,4,0,D,"Welsh, Don",2,Anfield
1952-12-13,1952,Liverpool,Manchester United,1-2,1,2,1,1,3,-1,A,"Welsh, Don",1,Anfield
1952-12-20,1952,Liverpool,Preston North End,2-2,2,2,1,1,4,0,D,"Welsh, Don",2,Anfield
1952-12-25,1952,Burnley,Liverpool,2-0,2,0,1,1,2,2,H,"Welsh, Don",0,Away
1952-12-26,1952,Liverpool,Burnley,1-1,1,1,1,1,2,0,D,"Welsh, Don",1,Anfield
1953-01-03,1952,Stoke City,Liverpool,3-1,3,1,1,1,4,2,H,"Welsh, Don",1,Away
1953-01-17,1952,Liverpool,Manchester City,0-1,0,1,1,1,1,-1,A,"Welsh, Don",0,Anfield
1953-01-24,1952,Portsmouth,Liverpool,3-1,3,1,1,1,4,2,H,"Welsh, Don",1,Away
1953-02-07,1952,Middlesbrough,Liverpool,2-3,2,3,1,1,5,-1,A,"Welsh, Don",3,Away
1953-02-14,1952,Liverpool,West Bromwich Albion,3-0,3,0,1,1,3,3,H,"Welsh, Don",3,Anfield
1953-02-21,1952,Newcastle United,Liverpool,1-2,1,2,1,1,3,-1,A,"Welsh, Don",2,Away
1953-03-04,1952,Liverpool,Bolton Wanderers,0-0,0,0,1,1,0,0,D,"Welsh, Don",0,Anfield
1953-03-07,1952,Aston Villa,Liverpool,4-0,4,0,1,1,4,4,H,"Welsh, Don",0,Away
1953-03-14,1952,Liverpool,Sunderland,2-0,2,0,1,1,2,2,H,"Welsh, Don",2,Anfield
1953-03-21,1952,Wolverhampton Wanderers,Liverpool,3-0,3,0,1,1,3,3,H,"Welsh, Don",0,Away
1953-03-23,1952,Chelsea,Liverpool,3-0,3,0,1,1,3,3,H,"Welsh, Don",0,Away
1953-03-28,1952,Liverpool,Charlton Athletic,1-2,1,2,1,1,3,-1,A,"Welsh, Don",1,Anfield
1953-04-03,1952,Liverpool,Cardiff City,2-1,2,1,1,1,3,1,H,"Welsh, Don",2,Anfield
1953-04-04,1952,Arsenal,Liverpool,5-3,5,3,1,1,8,2,H,"Welsh, Don",3,Away
1953-04-06,1952,Cardiff City,Liverpool,4-0,4,0,1,1,4,4,H,"Welsh, Don",0,Away
1953-04-11,1952,Liverpool,Derby County,1-1,1,1,1,1,2,0,D,"Welsh, Don",1,Anfield
1953-04-18,1952,Blackpool,Liverpool,3-1,3,1,1,1,4,2,H,"Welsh, Don",1,Away
1953-04-20,1952,Manchester United,Liverpool,3-1,3,1,1,1,4,2,H,"Welsh, Don",1,Away
1953-04-25,1952,Liverpool,Chelsea,2-0,2,0,1,1,2,2,H,"Welsh, Don",2,Anfield
1953-08-19,1953,Liverpool,Portsmouth,3-1,3,1,1,1,4,2,H,"Welsh, Don",3,Anfield
1953-08-22,1953,Liverpool,Manchester United,4-4,4,4,1,1,8,0,D,"Welsh, Don",4,Anfield
1953-08-26,1953,Liverpool,Newcastle United,2-2,2,2,1,1,4,0,D,"Welsh, Don",2,Anfield
1953-08-29,1953,Bolton Wanderers,Liverpool,2-0,2,0,1,1,2,2,H,"Welsh, Don",0,Away
1953-09-02,1953,Newcastle United,Liverpool,4-0,4,0,1,1,4,4,H,"Welsh, Don",0,Away
1953-09-05,1953,Liverpool,Preston North End,1-5,1,5,1,1,6,-4,A,"Welsh, Don",1,Anfield
1953-09-07,1953,Wolverhampton Wanderers,Liverpool,2-1,2,1,1,1,3,1,H,"Welsh, Don",1,Away
1953-09-12,1953,Tottenham Hotspur,Liverpool,2-1,2,1,1,1,3,1,H,"Welsh, Don",1,Away
1953-09-16,1953,Liverpool,Wolverhampton Wanderers,1-1,1,1,1,1,2,0,D,"Welsh, Don",1,Anfield
1953-09-19,1953,Liverpool,Burnley,4-0,4,0,1,1,4,4,H,"Welsh, Don",4,Anfield
1953-09-26,1953,Charlton Athletic,Liverpool,6-0,6,0,1,1,6,6,H,"Welsh, Don",0,Away
1953-10-03,1953,Liverpool,Sheffield Wednesday,2-2,2,2,1,1,4,0,D,"Welsh, Don",2,Anfield
1953-10-10,1953,Liverpool,Aston Villa,6-1,6,1,1,1,7,5,H,"Welsh, Don",6,Anfield
1953-10-17,1953,Huddersfield Town,Liverpool,2-0,2,0,1,1,2,2,H,"Welsh, Don",0,Away
1953-10-24,1953,Liverpool,Sheffield United,3-0,3,0,1,1,3,3,H,"Welsh, Don",3,Anfield
1953-10-31,1953,Chelsea,Liverpool,5-2,5,2,1,1,7,3,H,"Welsh, Don",2,Away
1953-11-07,1953,Liverpool,Manchester City,2-2,2,2,1,1,4,0,D,"Welsh, Don",2,Anfield
1953-11-14,1953,Sunderland,Liverpool,3-2,3,2,1,1,5,1,H,"Welsh, Don",2,Away
1953-11-21,1953,Liverpool,Arsenal,1-2,1,2,1,1,3,-1,A,"Welsh, Don",1,Anfield
1953-11-28,1953,Cardiff City,Liverpool,3-1,3,1,1,1,4,2,H,"Welsh, Don",1,Away
1953-12-05,1953,Liverpool,Blackpool,5-2,5,2,1,1,7,3,H,"Welsh, Don",5,Anfield
1953-12-12,1953,Portsmouth,Liverpool,5-1,5,1,1,1,6,4,H,"Welsh, Don",1,Away
1953-12-19,1953,Manchester United,Liverpool,5-1,5,1,1,1,6,4,H,"Welsh, Don",1,Away
1953-12-25,1953,West Bromwich Albion,Liverpool,5-2,5,2,1,1,7,3,H,"Welsh, Don",2,Away
1953-12-26,1953,Liverpool,West Bromwich Albion,0-0,0,0,1,1,0,0,D,"Welsh, Don",0,Anfield
1954-01-02,1953,Liverpool,Bolton Wanderers,1-2,1,2,1,1,3,-1,A,"Welsh, Don",1,Anfield
1954-01-16,1953,Preston North End,Liverpool,2-1,2,1,1,1,3,1,H,"Welsh, Don",1,Away
1954-01-23,1953,Liverpool,Tottenham Hotspur,2-2,2,2,1,1,4,0,D,"Welsh, Don",2,Anfield
1954-02-06,1953,Burnley,Liverpool,1-1,1,1,1,1,2,0,D,"Welsh, Don",1,Away
1954-02-13,1953,Liverpool,Charlton Athletic,2-3,2,3,1,1,5,-1,A,"Welsh, Don",2,Anfield
1954-02-24,1953,Sheffield Wednesday,Liverpool,1-1,1,1,1,1,2,0,D,"Welsh, Don",1,Away
1954-02-27,1953,Aston Villa,Liverpool,2-1,2,1,1,1,3,1,H,"Welsh, Don",1,Away
1954-03-06,1953,Liverpool,Huddersfield Town,1-3,1,3,1,1,4,-2,A,"Welsh, Don",1,Anfield
1954-03-13,1953,Sheffield United,Liverpool,3-1,3,1,1,1,4,2,H,"Welsh, Don",1,Away
1954-03-20,1953,Liverpool,Chelsea,1-1,1,1,1,1,2,0,D,"Welsh, Don",1,Anfield
1954-04-03,1953,Liverpool,Sunderland,4-3,4,3,1,1,7,1,H,"Welsh, Don",4,Anfield
1954-04-07,1953,Manchester City,Liverpool,0-2,0,2,1,1,2,-2,A,"Welsh, Don",2,Away
1954-04-10,1953,Arsenal,Liverpool,3-0,3,0,1,1,3,3,H,"Welsh, Don",0,Away
1954-04-16,1953,Middlesbrough,Liverpool,0-1,0,1,1,1,1,-1,A,"Welsh, Don",1,Away
1954-04-17,1953,Liverpool,Cardiff City,0-1,0,1,1,1,1,-1,A,"Welsh, Don",0,Anfield
1954-04-19,1953,Liverpool,Middlesbrough,4-1,4,1,1,1,5,3,H,"Welsh, Don",4,Anfield
1954-04-24,1953,Blackpool,Liverpool,3-0,3,0,1,1,3,3,H,"Welsh, Don",0,Away
1954-08-21,1954,Liverpool,Doncaster Rovers,3-2,3,2,2,2,5,1,H,"Welsh, Don",3,Anfield
1954-08-23,1954,Plymouth Argyle,Liverpool,1-0,1,0,2,2,1,1,H,"Welsh, Don",0,Away
1954-08-28,1954,Derby County,Liverpool,3-2,3,2,2,2,5,1,H,"Welsh, Don",2,Away
1954-09-01,1954,Liverpool,Plymouth Argyle,3-3,3,3,2,2,6,0,D,"Welsh, Don",3,Anfield
1954-09-04,1954,Liverpool,West Ham United,1-2,1,2,2,2,3,-1,A,"Welsh, Don",1,Anfield
1954-09-06,1954,Bristol Rovers,Liverpool,3-0,3,0,2,2,3,3,H,"Welsh, Don",0,Away
1954-09-11,1954,Blackburn Rovers,Liverpool,4-3,4,3,2,2,7,1,H,"Welsh, Don",3,Away
1954-09-15,1954,Liverpool,Bristol Rovers,5-3,5,3,2,2,8,2,H,"Welsh, Don",5,Anfield
1954-09-18,1954,Liverpool,Fulham,4-1,4,1,2,2,5,3,H,"Welsh, Don",4,Anfield
1954-09-25,1954,Swansea City,Liverpool,3-2,3,2,2,2,5,1,H,"Welsh, Don",2,Away
1954-10-02,1954,Liverpool,Notts County,3-1,3,1,2,2,4,2,H,"Welsh, Don",3,Anfield
1954-10-09,1954,Liverpool,Rotherham United,3-1,3,1,2,2,4,2,H,"Welsh, Don",3,Anfield
1954-10-16,1954,Stoke City,Liverpool,2-0,2,0,2,2,2,2,H,"Welsh, Don",0,Away
1954-10-23,1954,Liverpool,Bury,1-1,1,1,2,2,2,0,D,"Welsh, Don",1,Anfield
1954-10-30,1954,Lincoln City,Liverpool,3-3,3,3,2,2,6,0,D,"Welsh, Don",3,Away
1954-11-06,1954,Liverpool,Hull City,2-1,2,1,2,2,3,1,H,"Welsh, Don",2,Anfield
1954-11-13,1954,Luton Town,Liverpool,3-2,3,2,2,2,5,1,H,"Welsh, Don",2,Away
1954-11-20,1954,Liverpool,Nottingham Forest,1-0,1,0,2,2,1,1,H,"Welsh, Don",1,Anfield
1954-11-27,1954,Leeds United,Liverpool,2-2,2,2,2,2,4,0,D,"Welsh, Don",2,Away
1954-12-04,1954,Liverpool,Middlesbrough,3-1,3,1,2,2,4,2,H,"Welsh, Don",3,Anfield
1954-12-11,1954,Birmingham City,Liverpool,9-1,9,1,2,2,10,8,H,"Welsh, Don",1,Away
1954-12-18,1954,Doncaster Rovers,Liverpool,4-1,4,1,2,2,5,3,H,"Welsh, Don",1,Away
1954-12-25,1954,Liverpool,Ipswich Town,6-2,6,2,2,2,8,4,H,"Welsh, Don",6,Anfield
1954-12-27,1954,Ipswich Town,Liverpool,2-0,2,0,2,2,2,2,H,"Welsh, Don",0,Away
1955-01-01,1954,Liverpool,Derby County,2-0,2,0,2,2,2,2,H,"Welsh, Don",2,Anfield
1955-01-22,1954,Liverpool,Blackburn Rovers,4-1,4,1,2,2,5,3,H,"Welsh, Don",4,Anfield
1955-02-05,1954,Fulham,Liverpool,1-2,1,2,2,2,3,-1,A,"Welsh, Don",2,Away
1955-02-12,1954,Liverpool,Swansea City,1-1,1,1,2,2,2,0,D,"Welsh, Don",1,Anfield
1955-03-03,1954,Notts County,Liverpool,0-3,0,3,2,2,3,-3,A,"Welsh, Don",3,Away
1955-03-05,1954,Liverpool,Stoke City,2-4,2,4,2,2,6,-2,A,"Welsh, Don",2,Anfield
1955-03-12,1954,Bury,Liverpool,3-4,3,4,2,2,7,-1,A,"Welsh, Don",4,Away
1955-03-19,1954,Liverpool,Lincoln City,2-4,2,4,2,2,6,-2,A,"Welsh, Don",2,Anfield
1955-03-26,1954,Hull City,Liverpool,2-2,2,2,2,2,4,0,D,"Welsh, Don",2,Away
1955-04-02,1954,Liverpool,Luton Town,4-4,4,4,2,2,8,0,D,"Welsh, Don",4,Anfield
1955-04-08,1954,Port Vale,Liverpool,4-3,4,3,2,2,7,1,H,"Welsh, Don",3,Away
1955-04-09,1954,Nottingham Forest,Liverpool,3-1,3,1,2,2,4,2,H,"Welsh, Don",1,Away
1955-04-11,1954,Liverpool,Port Vale,1-1,1,1,2,2,2,0,D,"Welsh, Don",1,Anfield
1955-04-16,1954,Liverpool,Leeds United,2-2,2,2,2,2,4,0,D,"Welsh, Don",2,Anfield
1955-04-23,1954,Middlesbrough,Liverpool,1-2,1,2,2,2,3,-1,A,"Welsh, Don",2,Away
1955-04-26,1954,West Ham United,Liverpool,0-3,0,3,2,2,3,-3,A,"Welsh, Don",3,Away
1955-04-30,1954,Liverpool,Birmingham City,2-2,2,2,2,2,4,0,D,"Welsh, Don",2,Anfield
1955-05-02,1954,Rotherham United,Liverpool,6-1,6,1,2,2,7,5,H,"Welsh, Don",1,Away
1955-08-20,1955,Nottingham Forest,Liverpool,1-3,1,3,2,2,4,-2,A,"Welsh, Don",3,Away
1955-08-24,1955,Liverpool,Sheffield Wednesday,0-3,0,3,2,2,3,-3,A,"Welsh, Don",0,Anfield
1955-08-27,1955,Liverpool,Hull City,3-0,3,0,2,2,3,3,H,"Welsh, Don",3,Anfield
1955-08-31,1955,Sheffield Wednesday,Liverpool,1-1,1,1,2,2,2,0,D,"Welsh, Don",1,Away
1955-09-03,1955,Blackburn Rovers,Liverpool,3-3,3,3,2,2,6,0,D,"Welsh, Don",3,Away
1955-09-07,1955,Liverpool,Bristol Rovers,0-2,0,2,2,2,2,-2,A,"Welsh, Don",0,Anfield
1955-09-10,1955,Liverpool,Lincoln City,2-1,2,1,2,2,3,1,H,"Welsh, Don",2,Anfield
1955-09-17,1955,Leicester City,Liverpool,3-1,3,1,2,2,4,2,H,"Welsh, Don",1,Away
1955-09-24,1955,Liverpool,Middlesbrough,1-1,1,1,2,2,2,0,D,"Welsh, Don",1,Anfield
1955-10-01,1955,Liverpool,Plymouth Argyle,4-1,4,1,2,2,5,3,H,"Welsh, Don",4,Anfield
1955-10-08,1955,Bristol City,Liverpool,2-1,2,1,2,2,3,1,H,"Welsh, Don",1,Away
1955-10-15,1955,Liverpool,West Ham United,3-1,3,1,2,2,4,2,H,"Welsh, Don",3,Anfield
1955-10-22,1955,Bury,Liverpool,1-4,1,4,2,2,5,-3,A,"Welsh, Don",4,Away
1955-10-29,1955,Liverpool,Rotherham United,2-0,2,0,2,2,2,2,H,"Welsh, Don",2,Anfield
1955-11-05,1955,Swansea City,Liverpool,2-1,2,1,2,2,3,1,H,"Welsh, Don",1,Away
1955-11-12,1955,Liverpool,Notts County,2-1,2,1,2,2,3,1,H,"Welsh, Don",2,Anfield
1955-11-19,1955,Leeds United,Liverpool,4-2,4,2,2,2,6,2,H,"Welsh, Don",2,Away
1955-11-26,1955,Liverpool,Fulham,7-0,7,0,2,2,7,7,H,"Welsh, Don",7,Anfield
1955-12-03,1955,Port Vale,Liverpool,1-1,1,1,2,2,2,0,D,"Welsh, Don",1,Away
1955-12-10,1955,Liverpool,Barnsley,1-1,1,1,2,2,2,0,D,"Welsh, Don",1,Anfield
1955-12-17,1955,Liverpool,Nottingham Forest,5-2,5,2,2,2,7,3,H,"Welsh, Don",5,Anfield
1955-12-24,1955,Hull City,Liverpool,1-2,1,2,2,2,3,-1,A,"Welsh, Don",2,Away
1955-12-26,1955,Liverpool,Stoke City,2-2,2,2,2,2,4,0,D,"Welsh, Don",2,Anfield
1955-12-27,1955,Stoke City,Liverpool,3-2,3,2,2,2,5,1,H,"Welsh, Don",2,Away
1955-12-31,1955,Liverpool,Blackburn Rovers,1-2,1,2,2,2,3,-1,A,"Welsh, Don",1,Anfield
1956-01-21,1955,Liverpool,Leicester City,3-1,3,1,2,2,4,2,H,"Welsh, Don",3,Anfield
1956-02-04,1955,Middlesbrough,Liverpool,1-2,1,2,2,2,3,-1,A,"Welsh, Don",2,Away
1956-02-11,1955,Plymouth Argyle,Liverpool,4-0,4,0,2,2,4,4,H,"Welsh, Don",0,Away
1956-02-25,1955,West Ham United,Liverpool,2-0,2,0,2,2,2,2,H,"Welsh, Don",0,Away
1956-02-29,1955,Liverpool,Leeds United,1-0,1,0,2,2,1,1,H,"Welsh, Don",1,Anfield
1956-03-03,1955,Liverpool,Bury,4-2,4,2,2,2,6,2,H,"Welsh, Don",4,Anfield
1956-03-10,1955,Barnsley,Liverpool,0-5,0,5,2,2,5,-5,A,"Welsh, Don",5,Away
1956-03-17,1955,Liverpool,Swansea City,4-1,4,1,2,2,5,3,H,"Welsh, Don",4,Anfield
1956-03-24,1955,Notts County,Liverpool,2-1,2,1,2,2,3,1,H,"Welsh, Don",1,Away
1956-03-30,1955,Doncaster Rovers,Liverpool,1-0,1,0,2,2,1,1,H,"Welsh, Don",0,Away
1956-03-31,1955,Liverpool,Bristol City,2-1,2,1,2,2,3,1,H,"Welsh, Don",2,Anfield
1956-04-02,1955,Liverpool,Doncaster Rovers,1-2,1,2,2,2,3,-1,A,"Welsh, Don",1,Anfield
1956-04-07,1955,Fulham,Liverpool,3-1,3,1,2,2,4,2,H,"Welsh, Don",1,Away
1956-04-14,1955,Liverpool,Port Vale,4-1,4,1,2,2,5,3,H,"Welsh, Don",4,Anfield
1956-04-21,1955,Rotherham United,Liverpool,0-1,0,1,2,2,1,-1,A,"Welsh, Don",1,Away
1956-04-28,1955,Bristol Rovers,Liverpool,1-2,1,2,2,2,3,-1,A,"Welsh, Don",2,Away
1956-05-02,1955,Lincoln City,Liverpool,2-0,2,0,2,2,2,2,H,"Taylor, Phil",0,Away
1956-08-18,1956,Liverpool,Huddersfield Town,2-3,2,3,2,2,5,-1,A,"Taylor, Phil",2,Anfield
1956-08-23,1956,Notts County,Liverpool,1-1,1,1,2,2,2,0,D,"Taylor, Phil",1,Away
1956-08-25,1956,Bury,Liverpool,0-2,0,2,2,2,2,-2,A,"Taylor, Phil",2,Away
1956-08-29,1956,Liverpool,Notts County,3-3,3,3,2,2,6,0,D,"Taylor, Phil",3,Anfield
1956-09-01,1956,Liverpool,Grimsby Town,3-2,3,2,2,2,5,1,H,"Taylor, Phil",3,Anfield
1956-09-03,1956,West Ham United,Liverpool,1-1,1,1,2,2,2,0,D,"Taylor, Phil",1,Away
1956-09-08,1956,Doncaster Rovers,Liverpool,1-1,1,1,2,2,2,0,D,"Taylor, Phil",1,Away
1956-09-15,1956,Liverpool,Stoke City,0-2,0,2,2,2,2,-2,A,"Taylor, Phil",0,Anfield
1956-09-22,1956,Middlesbrough,Liverpool,1-1,1,1,2,2,2,0,D,"Taylor, Phil",1,Away
1956-09-29,1956,Liverpool,Leicester City,2-0,2,0,2,2,2,2,H,"Taylor, Phil",2,Anfield
1956-10-06,1956,Liverpool,Blackburn Rovers,2-3,2,3,2,2,5,-1,A,"Taylor, Phil",2,Anfield
1956-10-13,1956,Bristol City,Liverpool,2-1,2,1,2,2,3,1,H,"Taylor, Phil",1,Away
1956-10-20,1956,Liverpool,Fulham,4-3,4,3,2,2,7,1,H,"Taylor, Phil",4,Anfield
1956-10-27,1956,Barnsley,Liverpool,4-1,4,1,2,2,5,3,H,"Taylor, Phil",1,Away
1956-11-03,1956,Liverpool,Port Vale,4-1,4,1,2,2,5,3,H,"Taylor, Phil",4,Anfield
1956-11-10,1956,Rotherham United,Liverpool,2-2,2,2,2,2,4,0,D,"Taylor, Phil",2,Away
1956-11-17,1956,Liverpool,Lincoln City,4-0,4,0,2,2,4,4,H,"Taylor, Phil",4,Anfield
1956-11-24,1956,Swansea City,Liverpool,1-1,1,1,2,2,2,0,D,"Taylor, Phil",1,Away
1956-12-01,1956,Liverpool,Sheffield United,5-1,5,1,2,2,6,4,H,"Taylor, Phil",5,Anfield
1956-12-08,1956,Nottingham Forest,Liverpool,1-0,1,0,2,2,1,1,H,"Taylor, Phil",0,Away
1956-12-15,1956,Huddersfield Town,Liverpool,0-3,0,3,2,2,3,-3,A,"Taylor, Phil",3,Away
1956-12-22,1956,Liverpool,Bury,2-0,2,0,2,2,2,2,H,"Taylor, Phil",2,Anfield
1956-12-25,1956,Liverpool,Leyton Orient,1-0,1,0,2,2,1,1,H,"Taylor, Phil",1,Anfield
1956-12-26,1956,Leyton Orient,Liverpool,0-4,0,4,2,2,4,-4,A,"Taylor, Phil",4,Away
1956-12-29,1956,Grimsby Town,Liverpool,0-0,0,0,2,2,0,0,D,"Taylor, Phil",0,Away
1957-01-12,1956,Liverpool,Doncaster Rovers,2-1,2,1,2,2,3,1,H,"Taylor, Phil",2,Anfield
1957-01-19,1956,Stoke City,Liverpool,1-0,1,0,2,2,1,1,H,"Taylor, Phil",0,Away
1957-02-02,1956,Liverpool,Middlesbrough,1-2,1,2,2,2,3,-1,A,"Taylor, Phil",1,Anfield
1957-02-09,1956,Leicester City,Liverpool,3-2,3,2,2,2,5,1,H,"Taylor, Phil",2,Away
1957-02-16,1956,Blackburn Rovers,Liverpool,2-2,2,2,2,2,4,0,D,"Taylor, Phil",2,Away
1957-03-02,1956,Fulham,Liverpool,1-2,1,2,2,2,3,-1,A,"Taylor, Phil",2,Away
1957-03-09,1956,Liverpool,Barnsley,2-1,2,1,2,2,3,1,H,"Taylor, Phil",2,Anfield
1957-03-16,1956,Port Vale,Liverpool,1-2,1,2,2,2,3,-1,A,"Taylor, Phil",2,Away
1957-03-23,1956,Liverpool,Rotherham United,4-1,4,1,2,2,5,3,H,"Taylor, Phil",4,Anfield
1957-03-30,1956,Lincoln City,Liverpool,3-3,3,3,2,2,6,0,D,"Taylor, Phil",3,Away
1957-04-06,1956,Liverpool,Swansea City,2-0,2,0,2,2,2,2,H,"Taylor, Phil",2,Anfield
1957-04-13,1956,Sheffield United,Liverpool,3-0,3,0,2,2,3,3,H,"Taylor, Phil",0,Away
1957-04-19,1956,Liverpool,Bristol Rovers,4-1,4,1,2,2,5,3,H,"Taylor, Phil",4,Anfield
1957-04-20,1956,Liverpool,Nottingham Forest,3-1,3,1,2,2,4,2,H,"Taylor, Phil",3,Anfield
1957-04-22,1956,Bristol Rovers,Liverpool,0-0,0,0,2,2,0,0,D,"Taylor, Phil",0,Away
1957-04-27,1956,Liverpool,West Ham United,1-0,1,0,2,2,1,1,H,"Taylor, Phil",1,Anfield
1957-05-01,1956,Liverpool,Bristol City,2-1,2,1,2,2,3,1,H,"Taylor, Phil",2,Anfield
1957-08-24,1957,Bristol City,Liverpool,1-2,1,2,2,2,3,-1,A,"Taylor, Phil",2,Away
1957-08-28,1957,Liverpool,Huddersfield Town,1-1,1,1,2,2,2,0,D,"Taylor, Phil",1,Anfield
1957-08-31,1957,Liverpool,Cardiff City,3-0,3,0,2,2,3,3,H,"Taylor, Phil",3,Anfield
1957-09-04,1957,Huddersfield Town,Liverpool,2-1,2,1,2,2,3,1,H,"Taylor, Phil",1,Away
1957-09-07,1957,Fulham,Liverpool,2-2,2,2,2,2,4,0,D,"Taylor, Phil",2,Away
1957-09-14,1957,Middlesbrough,Liverpool,2-2,2,2,2,2,4,0,D,"Taylor, Phil",2,Away
1957-09-19,1957,Rotherham United,Liverpool,2-2,2,2,2,2,4,0,D,"Taylor, Phil",2,Away
1957-09-21,1957,Liverpool,Leyton Orient,3-0,3,0,2,2,3,3,H,"Taylor, Phil",3,Anfield
1957-09-23,1957,Stoke City,Liverpool,1-2,1,2,2,2,3,-1,A,"Taylor, Phil",2,Away
1957-09-28,1957,Charlton Athletic,Liverpool,5-1,5,1,2,2,6,4,H,"Taylor, Phil",1,Away
1957-10-05,1957,Liverpool,Doncaster Rovers,5-0,5,0,2,2,5,5,H,"Taylor, Phil",5,Anfield
1957-10-12,1957,Liverpool,Swansea City,4-0,4,0,2,2,4,4,H,"Taylor, Phil",4,Anfield
1957-10-19,1957,Derby County,Liverpool,2-1,2,1,2,2,3,1,H,"Taylor, Phil",1,Away
1957-10-26,1957,Liverpool,Bristol Rovers,2-0,2,0,2,2,2,2,H,"Taylor, Phil",2,Anfield
1957-11-02,1957,Lincoln City,Liverpool,0-1,0,1,2,2,1,-1,A,"Taylor, Phil",1,Away
1957-11-09,1957,Liverpool,Notts County,4-0,4,0,2,2,4,4,H,"Taylor, Phil",4,Anfield
1957-11-16,1957,Ipswich Town,Liverpool,3-1,3,1,2,2,4,2,H,"Taylor, Phil",1,Away
1957-11-23,1957,Liverpool,Blackburn Rovers,2-0,2,0,2,2,2,2,H,"Taylor, Phil",2,Anfield
1957-11-27,1957,Liverpool,Rotherham United,2-0,2,0,2,2,2,2,H,"Taylor, Phil",2,Anfield
1957-11-30,1957,Sheffield United,Liverpool,1-1,1,1,2,2,2,0,D,"Taylor, Phil",1,Away
1957-12-07,1957,Liverpool,West Ham United,1-1,1,1,2,2,2,0,D,"Taylor, Phil",1,Anfield
1957-12-14,1957,Barnsley,Liverpool,2-1,2,1,2,2,3,1,H,"Taylor, Phil",1,Away
1957-12-21,1957,Liverpool,Bristol City,4-3,4,3,2,2,7,1,H,"Taylor, Phil",4,Anfield
1957-12-25,1957,Grimsby Town,Liverpool,3-1,3,1,2,2,4,2,H,"Taylor, Phil",1,Away
1957-12-26,1957,Liverpool,Grimsby Town,3-2,3,2,2,2,5,1,H,"Taylor, Phil",3,Anfield
1957-12-28,1957,Cardiff City,Liverpool,6-1,6,1,2,2,7,5,H,"Taylor, Phil",1,Away
1958-01-11,1957,Liverpool,Fulham,2-1,2,1,2,2,3,1,H,"Taylor, Phil",2,Anfield
1958-01-18,1957,Liverpool,Middlesbrough,0-2,0,2,2,2,2,-2,A,"Taylor, Phil",0,Anfield
1958-02-01,1957,Leyton Orient,Liverpool,1-0,1,0,2,2,1,1,H,"Taylor, Phil",0,Away
1958-02-08,1957,Liverpool,Charlton Athletic,3-1,3,1,2,2,4,2,H,"Taylor, Phil",3,Anfield
1958-02-19,1957,Doncaster Rovers,Liverpool,1-1,1,1,2,2,2,0,D,"Taylor, Phil",1,Away
1958-02-22,1957,Blackburn Rovers,Liverpool,3-3,3,3,2,2,6,0,D,"Taylor, Phil",3,Away
1958-03-05,1957,Liverpool,Derby County,2-0,2,0,2,2,2,2,H,"Taylor, Phil",2,Anfield
1958-03-08,1957,Bristol Rovers,Liverpool,3-1,3,1,2,2,4,2,H,"Taylor, Phil",1,Away
1958-03-15,1957,Liverpool,Lincoln City,1-0,1,0,2,2,1,1,H,"Taylor, Phil",1,Anfield
1958-03-22,1957,Notts County,Liverpool,0-2,0,2,2,2,2,-2,A,"Taylor, Phil",2,Away
1958-03-29,1957,Liverpool,Ipswich Town,3-1,3,1,2,2,4,2,H,"Taylor, Phil",3,Anfield
1958-04-05,1957,Swansea City,Liverpool,0-2,0,2,2,2,2,-2,A,"Taylor, Phil",2,Away
1958-04-07,1957,Liverpool,Stoke City,3-0,3,0,2,2,3,3,H,"Taylor, Phil",3,Anfield
1958-04-12,1957,Liverpool,Sheffield United,1-0,1,0,2,2,1,1,H,"Taylor, Phil",1,Anfield
1958-04-19,1957,West Ham United,Liverpool,1-1,1,1,2,2,2,0,D,"Taylor, Phil",1,Away
1958-04-26,1957,Liverpool,Barnsley,1-1,1,1,2,2,2,0,D,"Taylor, Phil",1,Anfield
1958-08-23,1958,Liverpool,Grimsby Town,3-3,3,3,2,2,6,0,D,"Taylor, Phil",3,Anfield
1958-08-30,1958,Sunderland,Liverpool,2-1,2,1,2,2,3,1,H,"Taylor, Phil",1,Away
1958-09-03,1958,Liverpool,Brighton & Hove Albion,5-0,5,0,2,2,5,5,H,"Taylor, Phil",5,Anfield
1958-09-06,1958,Middlesbrough,Liverpool,2-1,2,1,2,2,3,1,H,"Taylor, Phil",1,Away
1958-09-10,1958,Liverpool,Sheffield United,2-1,2,1,2,2,3,1,H,"Taylor, Phil",2,Anfield
1958-09-13,1958,Liverpool,Charlton Athletic,3-0,3,0,2,2,3,3,H,"Taylor, Phil",3,Anfield
1958-09-15,1958,Sheffield United,Liverpool,2-0,2,0,2,2,2,2,H,"Taylor, Phil",0,Away
1958-09-20,1958,Bristol City,Liverpool,1-3,1,3,2,2,4,-2,A,"Taylor, Phil",3,Away
1958-09-24,1958,Brighton & Hove Albion,Liverpool,2-2,2,2,2,2,4,0,D,"Taylor, Phil",2,Away
1958-09-27,1958,Liverpool,Cardiff City,1-2,1,2,2,2,3,-1,A,"Taylor, Phil",1,Anfield
1958-10-04,1958,Huddersfield Town,Liverpool,5-0,5,0,2,2,5,5,H,"Taylor, Phil",0,Away
1958-10-11,1958,Liverpool,Lincoln City,3-2,3,2,2,2,5,1,H,"Taylor, Phil",3,Anfield
1958-10-18,1958,Fulham,Liverpool,0-1,0,1,2,2,1,-1,A,"Taylor, Phil",1,Away
1958-10-25,1958,Liverpool,Sheffield Wednesday,3-2,3,2,2,2,5,1,H,"Taylor, Phil",3,Anfield
1958-11-01,1958,Stoke City,Liverpool,0-2,0,2,2,2,2,-2,A,"Taylor, Phil",2,Away
1958-11-08,1958,Liverpool,Leyton Orient,3-0,3,0,2,2,3,3,H,"Taylor, Phil",3,Anfield
1958-11-15,1958,Derby County,Liverpool,3-2,3,2,2,2,5,1,H,"Taylor, Phil",2,Away
1958-11-22,1958,Liverpool,Bristol Rovers,2-1,2,1,2,2,3,1,H,"Taylor, Phil",2,Anfield
1958-11-29,1958,Ipswich Town,Liverpool,2-0,2,0,2,2,2,2,H,"Taylor, Phil",0,Away
1958-12-06,1958,Liverpool,Swansea City,4-0,4,0,2,2,4,4,H,"Taylor, Phil",4,Anfield
1958-12-13,1958,Scunthorpe United,Liverpool,1-2,1,2,2,2,3,-1,A,"Taylor, Phil",2,Away
1958-12-20,1958,Grimsby Town,Liverpool,2-3,2,3,2,2,5,-1,A,"Taylor, Phil",3,Away
1958-12-26,1958,Rotherham United,Liverpool,0-1,0,1,2,2,1,-1,A,"Taylor, Phil",1,Away
1958-12-27,1958,Liverpool,Rotherham United,4-0,4,0,2,2,4,4,H,"Taylor, Phil",4,Anfield
1959-01-03,1958,Liverpool,Sunderland,3-1,3,1,2,2,4,2,H,"Taylor, Phil",3,Anfield
1959-01-31,1958,Charlton Athletic,Liverpool,2-3,2,3,2,2,5,-1,A,"Taylor, Phil",3,Away
1959-02-07,1958,Liverpool,Bristol City,3-2,3,2,2,2,5,1,H,"Taylor, Phil",3,Anfield
1959-02-14,1958,Cardiff City,Liverpool,3-0,3,0,2,2,3,3,H,"Taylor, Phil",0,Away
1959-02-21,1958,Liverpool,Huddersfield Town,2-2,2,2,2,2,4,0,D,"Taylor, Phil",2,Anfield
1959-02-28,1958,Leyton Orient,Liverpool,1-3,1,3,2,2,4,-2,A,"Taylor, Phil",3,Away
1959-03-07,1958,Liverpool,Fulham,0-0,0,0,2,2,0,0,D,"Taylor, Phil",0,Anfield
1959-03-20,1958,Liverpool,Stoke City,3-4,3,4,2,2,7,-1,A,"Taylor, Phil",3,Anfield
1959-03-27,1958,Liverpool,Barnsley,3-2,3,2,2,2,5,1,H,"Taylor, Phil",3,Anfield
1959-03-28,1958,Lincoln City,Liverpool,2-1,2,1,2,2,3,1,H,"Taylor, Phil",1,Away
1959-03-30,1958,Barnsley,Liverpool,0-2,0,2,2,2,2,-2,A,"Taylor, Phil",2,Away
1959-04-04,1958,Liverpool,Derby County,3-0,3,0,2,2,3,3,H,"Taylor, Phil",3,Anfield
1959-04-08,1958,Liverpool,Middlesbrough,1-2,1,2,2,2,3,-1,A,"Taylor, Phil",1,Anfield
1959-04-11,1958,Bristol Rovers,Liverpool,3-0,3,0,2,2,3,3,H,"Taylor, Phil",0,Away
1959-04-14,1958,Sheffield Wednesday,Liverpool,1-0,1,0,2,2,1,1,H,"Taylor, Phil",0,Away
1959-04-18,1958,Liverpool,Ipswich Town,3-1,3,1,2,2,4,2,H,"Taylor, Phil",3,Anfield
1959-04-22,1958,Liverpool,Scunthorpe United,3-0,3,0,2,2,3,3,H,"Taylor, Phil",3,Anfield
1959-04-25,1958,Swansea City,Liverpool,3-3,3,3,2,2,6,0,D,"Taylor, Phil",3,Away
1959-08-22,1959,Cardiff City,Liverpool,3-2,3,2,2,2,5,1,H,"Taylor, Phil",2,Away
1959-08-26,1959,Liverpool,Bristol City,4-2,4,2,2,2,6,2,H,"Taylor, Phil",4,Anfield
1959-08-29,1959,Liverpool,Hull City,5-3,5,3,2,2,8,2,H,"Taylor, Phil",5,Anfield
1959-09-01,1959,Bristol City,Liverpool,1-0,1,0,2,2,1,1,H,"Taylor, Phil",0,Away
1959-09-05,1959,Sheffield United,Liverpool,2-1,2,1,2,2,3,1,H,"Taylor, Phil",1,Away
1959-09-09,1959,Liverpool,Scunthorpe United,2-0,2,0,2,2,2,2,H,"Taylor, Phil",2,Anfield
1959-09-12,1959,Liverpool,Middlesbrough,1-2,1,2,2,2,3,-1,A,"Taylor, Phil",1,Anfield
1959-09-17,1959,Scunthorpe United,Liverpool,1-1,1,1,2,2,2,0,D,"Taylor, Phil",1,Away
1959-09-19,1959,Derby County,Liverpool,1-2,1,2,2,2,3,-1,A,"Taylor, Phil",2,Away
1959-09-26,1959,Liverpool,Plymouth Argyle,4-1,4,1,2,2,5,3,H,"Taylor, Phil",4,Anfield
1959-10-03,1959,Swansea City,Liverpool,5-4,5,4,2,2,9,1,H,"Taylor, Phil",4,Away
1959-10-10,1959,Liverpool,Brighton & Hove Albion,2-2,2,2,2,2,4,0,D,"Taylor, Phil",2,Anfield
1959-10-17,1959,Stoke City,Liverpool,1-1,1,1,2,2,2,0,D,"Taylor, Phil",1,Away
1959-10-24,1959,Liverpool,Portsmouth,1-1,1,1,2,2,2,0,D,"Taylor, Phil",1,Anfield
1959-10-31,1959,Sunderland,Liverpool,1-1,1,1,2,2,2,0,D,"Taylor, Phil",1,Away
1959-11-07,1959,Liverpool,Aston Villa,2-1,2,1,2,2,3,1,H,"Taylor, Phil",2,Anfield
1959-11-14,1959,Lincoln City,Liverpool,4-2,4,2,2,2,6,2,H,"Taylor, Phil",2,Away
1959-11-21,1959,Liverpool,Leyton Orient,4-3,4,3,2,2,7,1,H,,4,Anfield
1959-11-28,1959,Huddersfield Town,Liverpool,1-0,1,0,2,2,1,1,H,,0,Away
1959-12-05,1959,Liverpool,Ipswich Town,3-1,3,1,2,2,4,2,H,"Shankly, Bill",3,Anfield
1959-12-12,1959,Bristol Rovers,Liverpool,0-2,0,2,2,2,2,-2,A,"Shankly, Bill",2,Away
1959-12-19,1959,Liverpool,Cardiff City,0-4,0,4,2,2,4,-4,A,"Shankly, Bill",0,Anfield
1959-12-26,1959,Charlton Athletic,Liverpool,3-0,3,0,2,2,3,3,H,"Shankly, Bill",0,Away
1959-12-28,1959,Liverpool,Charlton Athletic,2-0,2,0,2,2,2,2,H,"Shankly, Bill",2,Anfield
1960-01-02,1959,Hull City,Liverpool,0-1,0,1,2,2,1,-1,A,"Shankly, Bill",1,Away
1960-01-16,1959,Liverpool,Sheffield United,3-0,3,0,2,2,3,3,H,"Shankly, Bill",3,Anfield
1960-01-23,1959,Middlesbrough,Liverpool,3-3,3,3,2,2,6,0,D,"Shankly, Bill",3,Away
1960-02-13,1959,Plymouth Argyle,Liverpool,1-1,1,1,2,2,2,0,D,"Shankly, Bill",1,Away
1960-02-20,1959,Liverpool,Swansea City,4-1,4,1,2,2,5,3,H,"Shankly, Bill",4,Anfield
1960-02-27,1959,Brighton & Hove Albion,Liverpool,1-2,1,2,2,2,3,-1,A,"Shankly, Bill",2,Away
1960-03-05,1959,Liverpool,Stoke City,5-1,5,1,2,2,6,4,H,"Shankly, Bill",5,Anfield
1960-03-12,1959,Portsmouth,Liverpool,2-1,2,1,2,2,3,1,H,"Shankly, Bill",1,Away
1960-03-19,1959,Liverpool,Huddersfield Town,2-2,2,2,2,2,4,0,D,"Shankly, Bill",2,Anfield
1960-03-30,1959,Aston Villa,Liverpool,4-4,4,4,2,2,8,0,D,"Shankly, Bill",4,Away
1960-04-02,1959,Liverpool,Lincoln City,1-3,1,3,2,2,4,-2,A,"Shankly, Bill",1,Anfield
1960-04-06,1959,Liverpool,Derby County,4-1,4,1,2,2,5,3,H,"Shankly, Bill",4,Anfield
1960-04-09,1959,Leyton Orient,Liverpool,2-0,2,0,2,2,2,2,H,"Shankly, Bill",0,Away
1960-04-16,1959,Liverpool,Bristol Rovers,4-0,4,0,2,2,4,4,H,"Shankly, Bill",4,Anfield
1960-04-18,1959,Liverpool,Rotherham United,3-0,3,0,2,2,3,3,H,"Shankly, Bill",3,Anfield
1960-04-19,1959,Rotherham United,Liverpool,2-2,2,2,2,2,4,0,D,"Shankly, Bill",2,Away
1960-04-23,1959,Ipswich Town,Liverpool,0-1,0,1,2,2,1,-1,A,"Shankly, Bill",1,Away
1960-04-30,1959,Liverpool,Sunderland,3-0,3,0,2,2,3,3,H,"Shankly, Bill",3,Anfield
1960-08-20,1960,Liverpool,Leeds United,2-0,2,0,2,2,2,2,H,"Shankly, Bill",2,Anfield
1960-08-24,1960,Southampton,Liverpool,4-1,4,1,2,2,5,3,H,"Shankly, Bill",1,Away
1960-08-27,1960,Middlesbrough,Liverpool,1-1,1,1,2,2,2,0,D,"Shankly, Bill",1,Away
1960-08-31,1960,Liverpool,Southampton,0-1,0,1,2,2,1,-1,A,"Shankly, Bill",0,Anfield
1960-09-03,1960,Liverpool,Brighton & Hove Albion,2-0,2,0,2,2,2,2,H,"Shankly, Bill",2,Anfield
1960-09-07,1960,Liverpool,Luton Town,2-2,2,2,2,2,4,0,D,"Shankly, Bill",2,Anfield
1960-09-10,1960,Ipswich Town,Liverpool,1-0,1,0,2,2,1,1,H,"Shankly, Bill",0,Away
1960-09-14,1960,Luton Town,Liverpool,2-1,2,1,2,2,3,1,H,"Shankly, Bill",1,Away
1960-09-17,1960,Liverpool,Scunthorpe United,3-2,3,2,2,2,5,1,H,"Shankly, Bill",3,Anfield
1960-09-24,1960,Leyton Orient,Liverpool,1-3,1,3,2,2,4,-2,A,"Shankly, Bill",3,Away
1960-10-01,1960,Liverpool,Derby County,1-0,1,0,2,2,1,1,H,"Shankly, Bill",1,Anfield
1960-10-08,1960,Lincoln City,Liverpool,1-2,1,2,2,2,3,-1,A,"Shankly, Bill",2,Away
1960-10-15,1960,Liverpool,Portsmouth,3-3,3,3,2,2,6,0,D,"Shankly, Bill",3,Anfield
1960-10-22,1960,Huddersfield Town,Liverpool,2-4,2,4,2,2,6,-2,A,"Shankly, Bill",4,Away
1960-10-29,1960,Liverpool,Sunderland,1-1,1,1,2,2,2,0,D,"Shankly, Bill",1,Anfield
1960-11-05,1960,Plymouth Argyle,Liverpool,0-4,0,4,2,2,4,-4,A,"Shankly, Bill",4,Away
1960-11-12,1960,Liverpool,Norwich City,2-1,2,1,2,2,3,1,H,"Shankly, Bill",2,Anfield
1960-11-19,1960,Charlton Athletic,Liverpool,1-3,1,3,2,2,4,-2,A,"Shankly, Bill",3,Away
1960-11-26,1960,Liverpool,Sheffield United,4-2,4,2,2,2,6,2,H,"Shankly, Bill",4,Anfield
1960-12-10,1960,Liverpool,Swansea City,4-0,4,0,2,2,4,4,H,"Shankly, Bill",4,Anfield
1960-12-17,1960,Leeds United,Liverpool,2-2,2,2,2,2,4,0,D,"Shankly, Bill",2,Away
1960-12-26,1960,Liverpool,Rotherham United,2-1,2,1,2,2,3,1,H,"Shankly, Bill",2,Anfield
1960-12-27,1960,Rotherham United,Liverpool,1-0,1,0,2,2,1,1,H,"Shankly, Bill",0,Away
1960-12-31,1960,Liverpool,Middlesbrough,3-4,3,4,2,2,7,-1,A,"Shankly, Bill",3,Anfield
1961-01-14,1960,Brighton & Hove Albion,Liverpool,3-1,3,1,2,2,4,2,H,"Shankly, Bill",1,Away
1961-01-21,1960,Liverpool,Ipswich Town,1-1,1,1,2,2,2,0,D,"Shankly, Bill",1,Anfield
1961-02-04,1960,Scunthorpe United,Liverpool,2-3,2,3,2,2,5,-1,A,"Shankly, Bill",3,Away
1961-02-11,1960,Liverpool,Leyton Orient,5-0,5,0,2,2,5,5,H,"Shankly, Bill",5,Anfield
1961-02-18,1960,Derby County,Liverpool,1-4,1,4,2,2,5,-3,A,"Shankly, Bill",4,Away
1961-02-25,1960,Liverpool,Lincoln City,2-0,2,0,2,2,2,2,H,"Shankly, Bill",2,Anfield
1961-03-04,1960,Portsmouth,Liverpool,2-2,2,2,2,2,4,0,D,"Shankly, Bill",2,Away
1961-03-11,1960,Liverpool,Huddersfield Town,3-1,3,1,2,2,4,2,H,"Shankly, Bill",3,Anfield
1961-03-18,1960,Swansea City,Liverpool,2-0,2,0,2,2,2,2,H,"Shankly, Bill",0,Away
1961-03-24,1960,Liverpool,Plymouth Argyle,1-1,1,1,2,2,2,0,D,"Shankly, Bill",1,Anfield
1961-03-31,1960,Liverpool,Bristol Rovers,3-0,3,0,2,2,3,3,H,"Shankly, Bill",3,Anfield
1961-04-01,1960,Sheffield United,Liverpool,1-1,1,1,2,2,2,0,D,"Shankly, Bill",1,Away
1961-04-04,1960,Bristol Rovers,Liverpool,4-3,4,3,2,2,7,1,H,"Shankly, Bill",3,Away
1961-04-08,1960,Liverpool,Charlton Athletic,2-1,2,1,2,2,3,1,H,"Shankly, Bill",2,Anfield
1961-04-15,1960,Norwich City,Liverpool,2-1,2,1,2,2,3,1,H,"Shankly, Bill",1,Away
1961-04-22,1960,Liverpool,Stoke City,3-0,3,0,2,2,3,3,H,"Shankly, Bill",3,Anfield
1961-04-29,1960,Sunderland,Liverpool,1-1,1,1,2,2,2,0,D,"Shankly, Bill",1,Away
1961-05-03,1960,Stoke City,Liverpool,3-1,3,1,2,2,4,2,H,"Shankly, Bill",1,Away
1961-08-19,1961,Bristol Rovers,Liverpool,0-2,0,2,2,2,2,-2,A,"Shankly, Bill",2,Away
1961-08-23,1961,Liverpool,Sunderland,3-0,3,0,2,2,3,3,H,"Shankly, Bill",3,Anfield
1961-08-26,1961,Liverpool,Leeds United,5-0,5,0,2,2,5,5,H,"Shankly, Bill",5,Anfield
1961-08-30,1961,Sunderland,Liverpool,1-4,1,4,2,2,5,-3,A,"Shankly, Bill",4,Away
1961-09-02,1961,Norwich City,Liverpool,1-2,1,2,2,2,3,-1,A,"Shankly, Bill",2,Away
1961-09-09,1961,Liverpool,Scunthorpe United,2-1,2,1,2,2,3,1,H,"Shankly, Bill",2,Anfield
1961-09-16,1961,Brighton & Hove Albion,Liverpool,0-0,0,0,2,2,0,0,D,"Shankly, Bill",0,Away
1961-09-20,1961,Newcastle United,Liverpool,1-2,1,2,2,2,3,-1,A,"Shankly, Bill",2,Away
1961-09-23,1961,Liverpool,Bury,5-0,5,0,2,2,5,5,H,"Shankly, Bill",5,Anfield
1961-09-30,1961,Charlton Athletic,Liverpool,0-4,0,4,2,2,4,-4,A,"Shankly, Bill",4,Away
1961-10-04,1961,Liverpool,Newcastle United,2-0,2,0,2,2,2,2,H,"Shankly, Bill",2,Anfield
1961-10-07,1961,Middlesbrough,Liverpool,2-0,2,0,2,2,2,2,H,"Shankly, Bill",0,Away
1961-10-14,1961,Liverpool,Walsall,6-1,6,1,2,2,7,5,H,"Shankly, Bill",6,Anfield
1961-10-21,1961,Derby County,Liverpool,2-0,2,0,2,2,2,2,H,"Shankly, Bill",0,Away
1961-10-28,1961,Liverpool,Leyton Orient,3-3,3,3,2,2,6,0,D,"Shankly, Bill",3,Anfield
1961-11-04,1961,Preston North End,Liverpool,1-3,1,3,2,2,4,-2,A,"Shankly, Bill",3,Away
1961-11-11,1961,Liverpool,Luton Town,1-1,1,1,2,2,2,0,D,"Shankly, Bill",1,Anfield
1961-11-18,1961,Huddersfield Town,Liverpool,1-2,1,2,2,2,3,-1,A,"Shankly, Bill",2,Away
1961-11-25,1961,Liverpool,Swansea City,5-0,5,0,2,2,5,5,H,"Shankly, Bill",5,Anfield
1961-12-02,1961,Southampton,Liverpool,2-0,2,0,2,2,2,2,H,"Shankly, Bill",0,Away
1961-12-09,1961,Liverpool,Plymouth Argyle,2-1,2,1,2,2,3,1,H,"Shankly, Bill",2,Anfield
1961-12-16,1961,Liverpool,Bristol Rovers,2-0,2,0,2,2,2,2,H,"Shankly, Bill",2,Anfield
1961-12-23,1961,Leeds United,Liverpool,1-0,1,0,2,2,1,1,H,"Shankly, Bill",0,Away
1961-12-26,1961,Rotherham United,Liverpool,1-0,1,0,2,2,1,1,H,"Shankly, Bill",0,Away
1962-01-13,1961,Liverpool,Norwich City,5-4,5,4,2,2,9,1,H,"Shankly, Bill",5,Anfield
1962-01-20,1961,Scunthorpe United,Liverpool,1-1,1,1,2,2,2,0,D,"Shankly, Bill",1,Away
1962-02-03,1961,Liverpool,Brighton & Hove Albion,3-1,3,1,2,2,4,2,H,"Shankly, Bill",3,Anfield
1962-02-10,1961,Bury,Liverpool,0-3,0,3,2,2,3,-3,A,"Shankly, Bill",3,Away
1962-02-24,1961,Liverpool,Middlesbrough,5-1,5,1,2,2,6,4,H,"Shankly, Bill",5,Anfield
1962-03-03,1961,Walsall,Liverpool,1-1,1,1,2,2,2,0,D,"Shankly, Bill",1,Away
1962-03-10,1961,Liverpool,Derby County,4-1,4,1,2,2,5,3,H,"Shankly, Bill",4,Anfield
1962-03-17,1961,Leyton Orient,Liverpool,2-2,2,2,2,2,4,0,D,"Shankly, Bill",2,Away
1962-03-24,1961,Liverpool,Preston North End,4-1,4,1,2,2,5,3,H,"Shankly, Bill",4,Anfield
1962-03-28,1961,Liverpool,Rotherham United,4-1,4,1,2,2,5,3,H,"Shankly, Bill",4,Anfield
1962-03-31,1961,Luton Town,Liverpool,1-0,1,0,2,2,1,1,H,"Shankly, Bill",0,Away
1962-04-07,1961,Liverpool,Huddersfield Town,1-1,1,1,2,2,2,0,D,"Shankly, Bill",1,Anfield
1962-04-21,1961,Liverpool,Southampton,2-0,2,0,2,2,2,2,H,"Shankly, Bill",2,Anfield
1962-04-23,1961,Liverpool,Stoke City,2-1,2,1,2,2,3,1,H,"Shankly, Bill",2,Anfield
1962-04-24,1961,Stoke City,Liverpool,0-0,0,0,2,2,0,0,D,"Shankly, Bill",0,Away
1962-04-28,1961,Plymouth Argyle,Liverpool,2-3,2,3,2,2,5,-1,A,"Shankly, Bill",3,Away
1962-04-30,1961,Liverpool,Charlton Athletic,2-1,2,1,2,2,3,1,H,"Shankly, Bill",2,Anfield
1962-05-04,1961,Swansea City,Liverpool,4-2,4,2,2,2,6,2,H,"Shankly, Bill",2,Away
1962-08-18,1962,Liverpool,Blackpool,1-2,1,2,1,1,3,-1,A,"Shankly, Bill",1,Anfield
1962-08-22,1962,Manchester City,Liverpool,2-2,2,2,1,1,4,0,D,"Shankly, Bill",2,Away
1962-08-25,1962,Blackburn Rovers,Liverpool,1-0,1,0,1,1,1,1,H,"Shankly, Bill",0,Away
1962-08-29,1962,Liverpool,Manchester City,4-1,4,1,1,1,5,3,H,"Shankly, Bill",4,Anfield
1962-09-01,1962,Liverpool,Sheffield United,2-0,2,0,1,1,2,2,H,"Shankly, Bill",2,Anfield
1962-09-03,1962,West Ham United,Liverpool,1-0,1,0,1,1,1,1,H,"Shankly, Bill",0,Away
1962-09-08,1962,Nottingham Forest,Liverpool,3-1,3,1,1,1,4,2,H,"Shankly, Bill",1,Away
1962-09-12,1962,Liverpool,West Ham United,2-1,2,1,1,1,3,1,H,"Shankly, Bill",2,Anfield
1962-09-15,1962,Liverpool,Ipswich Town,1-1,1,1,1,1,2,0,D,"Shankly, Bill",1,Anfield
1962-09-22,1962,Everton,Liverpool,2-2,2,2,1,1,4,0,D,"Shankly, Bill",2,Away
1962-09-29,1962,Wolverhampton Wanderers,Liverpool,3-2,3,2,1,1,5,1,H,"Shankly, Bill",2,Away
1962-10-06,1962,Liverpool,Bolton Wanderers,1-0,1,0,1,1,1,1,H,"Shankly, Bill",1,Anfield
1962-10-13,1962,Leicester City,Liverpool,3-0,3,0,1,1,3,3,H,"Shankly, Bill",0,Away
1962-10-27,1962,West Bromwich Albion,Liverpool,1-0,1,0,1,1,1,1,H,"Shankly, Bill",0,Away
1962-11-03,1962,Liverpool,Burnley,1-2,1,2,1,1,3,-1,A,"Shankly, Bill",1,Anfield
1962-11-10,1962,Manchester United,Liverpool,3-3,3,3,1,1,6,0,D,"Shankly, Bill",3,Away
1962-11-14,1962,Liverpool,Arsenal,2-1,2,1,1,1,3,1,H,"Shankly, Bill",2,Anfield
1962-11-17,1962,Liverpool,Leyton Orient,5-0,5,0,1,1,5,5,H,"Shankly, Bill",5,Anfield
1962-11-24,1962,Birmingham City,Liverpool,0-2,0,2,1,1,2,-2,A,"Shankly, Bill",2,Away
1962-12-01,1962,Liverpool,Fulham,2-1,2,1,1,1,3,1,H,"Shankly, Bill",2,Anfield
1962-12-08,1962,Sheffield Wednesday,Liverpool,0-2,0,2,1,1,2,-2,A,"Shankly, Bill",2,Away
1962-12-15,1962,Blackpool,Liverpool,1-2,1,2,1,1,3,-1,A,"Shankly, Bill",2,Away
1962-12-22,1962,Liverpool,Blackburn Rovers,3-1,3,1,1,1,4,2,H,"Shankly, Bill",3,Anfield
1963-02-13,1962,Liverpool,Aston Villa,4-0,4,0,1,1,4,4,H,"Shankly, Bill",4,Anfield
1963-02-16,1962,Liverpool,Wolverhampton Wanderers,4-1,4,1,1,1,5,3,H,"Shankly, Bill",4,Anfield
1963-03-02,1962,Liverpool,Leicester City,0-2,0,2,1,1,2,-2,A,"Shankly, Bill",0,Anfield
1963-03-05,1962,Ipswich Town,Liverpool,2-2,2,2,1,1,4,0,D,"Shankly, Bill",2,Away
1963-03-09,1962,Arsenal,Liverpool,2-2,2,2,1,1,4,0,D,"Shankly, Bill",2,Away
1963-03-20,1962,Liverpool,West Bromwich Albion,2-2,2,2,1,1,4,0,D,"Shankly, Bill",2,Anfield
1963-03-23,1962,Burnley,Liverpool,1-3,1,3,1,1,4,-2,A,"Shankly, Bill",3,Away
1963-04-08,1962,Liverpool,Everton,0-0,0,0,1,1,0,0,D,"Shankly, Bill",0,Anfield
1963-04-12,1962,Liverpool,Tottenham Hotspur,5-2,5,2,1,1,7,3,H,"Shankly, Bill",5,Anfield
1963-04-13,1962,Liverpool,Manchester United,1-0,1,0,1,1,1,1,H,"Shankly, Bill",1,Anfield
1963-04-15,1962,Tottenham Hotspur,Liverpool,7-2,7,2,1,1,9,5,H,"Shankly, Bill",2,Away
1963-04-18,1962,Liverpool,Nottingham Forest,0-2,0,2,1,1,2,-2,A,"Shankly, Bill",0,Anfield
1963-04-20,1962,Fulham,Liverpool,0-0,0,0,1,1,0,0,D,"Shankly, Bill",0,Away
1963-04-29,1962,Liverpool,Sheffield Wednesday,0-2,0,2,1,1,2,-2,A,"Shankly, Bill",0,Anfield
1963-05-02,1962,Leyton Orient,Liverpool,2-1,2,1,1,1,3,1,H,"Shankly, Bill",1,Away
1963-05-08,1962,Liverpool,Birmingham City,5-1,5,1,1,1,6,4,H,"Shankly, Bill",5,Anfield
1963-05-11,1962,Sheffield United,Liverpool,0-0,0,0,1,1,0,0,D,"Shankly, Bill",0,Away
1963-05-13,1962,Bolton Wanderers,Liverpool,1-0,1,0,1,1,1,1,H,"Shankly, Bill",0,Away
1963-05-18,1962,Aston Villa,Liverpool,2-0,2,0,1,1,2,2,H,"Shankly, Bill",0,Away
1963-08-24,1963,Blackburn Rovers,Liverpool,1-2,1,2,1,1,3,-1,A,"Shankly, Bill",2,Away
1963-08-28,1963,Liverpool,Nottingham Forest,1-2,1,2,1,1,3,-1,A,"Shankly, Bill",1,Anfield
1963-08-31,1963,Liverpool,Blackpool,1-2,1,2,1,1,3,-1,A,"Shankly, Bill",1,Anfield
1963-09-03,1963,Nottingham Forest,Liverpool,0-0,0,0,1,1,0,0,D,"Shankly, Bill",0,Away
1963-09-07,1963,Chelsea,Liverpool,1-3,1,3,1,1,4,-2,A,"Shankly, Bill",3,Away
1963-09-09,1963,Wolverhampton Wanderers,Liverpool,1-3,1,3,1,1,4,-2,A,"Shankly, Bill",3,Away
1963-09-14,1963,Liverpool,West Ham United,1-2,1,2,1,1,3,-1,A,"Shankly, Bill",1,Anfield
1963-09-16,1963,Liverpool,Wolverhampton Wanderers,6-0,6,0,1,1,6,6,H,"Shankly, Bill",6,Anfield
1963-09-21,1963,Sheffield United,Liverpool,3-0,3,0,1,1,3,3,H,"Shankly, Bill",0,Away
1963-09-28,1963,Liverpool,Everton,2-1,2,1,1,1,3,1,H,"Shankly, Bill",2,Anfield
1963-10-05,1963,Liverpool,Aston Villa,5-2,5,2,1,1,7,3,H,"Shankly, Bill",5,Anfield
1963-10-09,1963,Liverpool,Sheffield Wednesday,3-1,3,1,1,1,4,2,H,"Shankly, Bill",3,Anfield
1963-10-19,1963,Liverpool,West Bromwich Albion,1-0,1,0,1,1,1,1,H,"Shankly, Bill",1,Anfield
1963-10-26,1963,Ipswich Town,Liverpool,1-2,1,2,1,1,3,-1,A,"Shankly, Bill",2,Away
1963-11-02,1963,Liverpool,Leicester City,0-1,0,1,1,1,1,-1,A,"Shankly, Bill",0,Anfield
1963-11-09,1963,Bolton Wanderers,Liverpool,1-2,1,2,1,1,3,-1,A,"Shankly, Bill",2,Away
1963-11-16,1963,Liverpool,Fulham,2-0,2,0,1,1,2,2,H,"Shankly, Bill",2,Anfield
1963-11-23,1963,Manchester United,Liverpool,0-1,0,1,1,1,1,-1,A,"Shankly, Bill",1,Away
1963-11-30,1963,Liverpool,Burnley,2-0,2,0,1,1,2,2,H,"Shankly, Bill",2,Anfield
1963-12-07,1963,Arsenal,Liverpool,1-1,1,1,1,1,2,0,D,"Shankly, Bill",1,Away
1963-12-14,1963,Liverpool,Blackburn Rovers,1-2,1,2,1,1,3,-1,A,"Shankly, Bill",1,Anfield
1963-12-21,1963,Blackpool,Liverpool,0-1,0,1,1,1,1,-1,A,"Shankly, Bill",1,Away
1963-12-26,1963,Liverpool,Stoke City,6-1,6,1,1,1,7,5,H,"Shankly, Bill",6,Anfield
1964-01-11,1963,Liverpool,Chelsea,2-1,2,1,1,1,3,1,H,"Shankly, Bill",2,Anfield
1964-01-18,1963,West Ham United,Liverpool,1-0,1,0,1,1,1,1,H,"Shankly, Bill",0,Away
1964-02-01,1963,Liverpool,Sheffield United,6-1,6,1,1,1,7,5,H,"Shankly, Bill",6,Anfield
1964-02-08,1963,Everton,Liverpool,3-1,3,1,1,1,4,2,H,"Shankly, Bill",1,Away
1964-02-19,1963,Aston Villa,Liverpool,2-2,2,2,1,1,4,0,D,"Shankly, Bill",2,Away
1964-02-22,1963,Liverpool,Birmingham City,2-1,2,1,1,1,3,1,H,"Shankly, Bill",2,Anfield
1964-03-04,1963,Sheffield Wednesday,Liverpool,2-2,2,2,1,1,4,0,D,"Shankly, Bill",2,Away
1964-03-07,1963,Liverpool,Ipswich Town,6-0,6,0,1,1,6,6,H,"Shankly, Bill",6,Anfield
1964-03-14,1963,Fulham,Liverpool,1-0,1,0,1,1,1,1,H,"Shankly, Bill",0,Away
1964-03-20,1963,Liverpool,Bolton Wanderers,2-0,2,0,1,1,2,2,H,"Shankly, Bill",2,Anfield
1964-03-27,1963,Tottenham Hotspur,Liverpool,1-3,1,3,1,1,4,-2,A,"Shankly, Bill",3,Away
1964-03-28,1963,Leicester City,Liverpool,0-2,0,2,1,1,2,-2,A,"Shankly, Bill",2,Away
1964-03-30,1963,Liverpool,Tottenham Hotspur,3-1,3,1,1,1,4,2,H,"Shankly, Bill",3,Anfield
1964-04-04,1963,Liverpool,Manchester United,3-0,3,0,1,1,3,3,H,"Shankly, Bill",3,Anfield
1964-04-14,1963,Burnley,Liverpool,0-3,0,3,1,1,3,-3,A,"Shankly, Bill",3,Away
1964-04-18,1963,Liverpool,Arsenal,5-0,5,0,1,1,5,5,H,"Shankly, Bill",5,Anfield
1964-04-22,1963,Birmingham City,Liverpool,3-1,3,1,1,1,4,2,H,"Shankly, Bill",1,Away
1964-04-25,1963,West Bromwich Albion,Liverpool,2-2,2,2,1,1,4,0,D,"Shankly, Bill",2,Away
1964-04-29,1963,Stoke City,Liverpool,3-1,3,1,1,1,4,2,H,"Shankly, Bill",1,Away
1964-08-22,1964,Liverpool,Arsenal,3-2,3,2,1,1,5,1,H,"Shankly, Bill",3,Anfield
1964-08-26,1964,Leeds United,Liverpool,4-2,4,2,1,1,6,2,H,"Shankly, Bill",2,Away
1964-08-29,1964,Blackburn Rovers,Liverpool,3-2,3,2,1,1,5,1,H,"Shankly, Bill",2,Away
1964-09-02,1964,Liverpool,Leeds United,2-1,2,1,1,1,3,1,H,"Shankly, Bill",2,Anfield
1964-09-05,1964,Liverpool,Blackpool,2-2,2,2,1,1,4,0,D,"Shankly, Bill",2,Anfield
1964-09-09,1964,Leicester City,Liverpool,2-0,2,0,1,1,2,2,H,"Shankly, Bill",0,Away
1964-09-12,1964,Sheffield Wednesday,Liverpool,1-0,1,0,1,1,1,1,H,"Shankly, Bill",0,Away
1964-09-19,1964,Liverpool,Everton,0-4,0,4,1,1,4,-4,A,"Shankly, Bill",0,Anfield
1964-09-26,1964,Liverpool,Aston Villa,5-1,5,1,1,1,6,4,H,"Shankly, Bill",5,Anfield
1964-10-07,1964,Liverpool,Sheffield United,3-1,3,1,1,1,4,2,H,"Shankly, Bill",3,Anfield
1964-10-10,1964,Birmingham City,Liverpool,0-0,0,0,1,1,0,0,D,"Shankly, Bill",0,Away
1964-10-13,1964,Liverpool,Leicester City,0-1,0,1,1,1,1,-1,A,"Shankly, Bill",0,Anfield
1964-10-17,1964,Liverpool,West Ham United,2-2,2,2,1,1,4,0,D,"Shankly, Bill",2,Anfield
1964-10-24,1964,West Bromwich Albion,Liverpool,3-0,3,0,1,1,3,3,H,"Shankly, Bill",0,Away
1964-10-31,1964,Liverpool,Manchester United,0-2,0,2,1,1,2,-2,A,"Shankly, Bill",0,Anfield
1964-11-07,1964,Fulham,Liverpool,1-1,1,1,1,1,2,0,D,"Shankly, Bill",1,Away
1964-11-14,1964,Liverpool,Nottingham Forest,2-0,2,0,1,1,2,2,H,"Shankly, Bill",2,Anfield
1964-11-21,1964,Stoke City,Liverpool,1-1,1,1,1,1,2,0,D,"Shankly, Bill",1,Away
1964-11-28,1964,Liverpool,Tottenham Hotspur,1-1,1,1,1,1,2,0,D,"Shankly, Bill",1,Anfield
1964-12-05,1964,Burnley,Liverpool,1-5,1,5,1,1,6,-4,A,"Shankly, Bill",5,Away
1964-12-12,1964,Arsenal,Liverpool,0-0,0,0,1,1,0,0,D,"Shankly, Bill",0,Away
1964-12-19,1964,Liverpool,Blackburn Rovers,3-2,3,2,1,1,5,1,H,"Shankly, Bill",3,Anfield
1964-12-26,1964,Sunderland,Liverpool,2-3,2,3,1,1,5,-1,A,"Shankly, Bill",3,Away
1964-12-28,1964,Liverpool,Sunderland,0-0,0,0,1,1,0,0,D,"Shankly, Bill",0,Anfield
1965-01-02,1964,Blackpool,Liverpool,2-3,2,3,1,1,5,-1,A,"Shankly, Bill",3,Away
1965-01-16,1964,Liverpool,Sheffield Wednesday,4-2,4,2,1,1,6,2,H,"Shankly, Bill",4,Anfield
1965-02-06,1964,Aston Villa,Liverpool,0-1,0,1,1,1,1,-1,A,"Shankly, Bill",1,Away
1965-02-13,1964,Liverpool,Wolverhampton Wanderers,2-1,2,1,1,1,3,1,H,"Shankly, Bill",2,Anfield
1965-02-24,1964,Liverpool,Birmingham City,4-3,4,3,1,1,7,1,H,"Shankly, Bill",4,Anfield
1965-02-27,1964,West Ham United,Liverpool,2-1,2,1,1,1,3,1,H,"Shankly, Bill",1,Away
1965-03-13,1964,Sheffield United,Liverpool,3-0,3,0,1,1,3,3,H,"Shankly, Bill",0,Away
1965-03-20,1964,Liverpool,Fulham,3-2,3,2,1,1,5,1,H,"Shankly, Bill",3,Anfield
1965-04-01,1964,Nottingham Forest,Liverpool,2-2,2,2,1,1,4,0,D,"Shankly, Bill",2,Away
1965-04-03,1964,Liverpool,Stoke City,3-2,3,2,1,1,5,1,H,"Shankly, Bill",3,Anfield
1965-04-06,1964,Liverpool,West Bromwich Albion,0-3,0,3,1,1,3,-3,A,"Shankly, Bill",0,Anfield
1965-04-09,1964,Tottenham Hotspur,Liverpool,3-0,3,0,1,1,3,3,H,"Shankly, Bill",0,Away
1965-04-12,1964,Everton,Liverpool,2-1,2,1,1,1,3,1,H,"Shankly, Bill",1,Away
1965-04-16,1964,Chelsea,Liverpool,4-0,4,0,1,1,4,4,H,"Shankly, Bill",0,Away
1965-04-17,1964,Liverpool,Burnley,1-1,1,1,1,1,2,0,D,"Shankly, Bill",1,Anfield
1965-04-19,1964,Liverpool,Chelsea,2-0,2,0,1,1,2,2,H,"Shankly, Bill",2,Anfield
1965-04-24,1964,Manchester United,Liverpool,3-0,3,0,1,1,3,3,H,"Shankly, Bill",0,Away
1965-04-26,1964,Wolverhampton Wanderers,Liverpool,1-3,1,3,1,1,4,-2,A,"Shankly, Bill",3,Away
1965-08-21,1965,Leicester City,Liverpool,1-3,1,3,1,1,4,-2,A,"Shankly, Bill",3,Away
1965-08-25,1965,Liverpool,Sheffield United,0-1,0,1,1,1,1,-1,A,"Shankly, Bill",0,Anfield
1965-09-01,1965,Sheffield United,Liverpool,0-0,0,0,1,1,0,0,D,"Shankly, Bill",0,Away
1965-09-04,1965,Blackpool,Liverpool,2-3,2,3,1,1,5,-1,A,"Shankly, Bill",3,Away
1965-09-06,1965,West Ham United,Liverpool,1-5,1,5,1,1,6,-4,A,"Shankly, Bill",5,Away
1965-09-11,1965,Liverpool,Fulham,2-1,2,1,1,1,3,1,H,"Shankly, Bill",2,Anfield
1965-09-15,1965,Liverpool,West Ham United,1-1,1,1,1,1,2,0,D,"Shankly, Bill",1,Anfield
1965-09-18,1965,Tottenham Hotspur,Liverpool,2-1,2,1,1,1,3,1,H,"Shankly, Bill",1,Away
1965-09-25,1965,Liverpool,Everton,5-0,5,0,1,1,5,5,H,"Shankly, Bill",5,Anfield
1965-10-02,1965,Liverpool,Aston Villa,3-1,3,1,1,1,4,2,H,"Shankly, Bill",3,Anfield
1965-10-09,1965,Manchester United,Liverpool,2-0,2,0,1,1,2,2,H,"Shankly, Bill",0,Away
1965-10-16,1965,Liverpool,Newcastle United,2-0,2,0,1,1,2,2,H,"Shankly, Bill",2,Anfield
1965-10-23,1965,West Bromwich Albion,Liverpool,3-0,3,0,1,1,3,3,H,"Shankly, Bill",0,Away
1965-10-30,1965,Liverpool,Nottingham Forest,4-0,4,0,1,1,4,4,H,"Shankly, Bill",4,Anfield
1965-11-06,1965,Sheffield Wednesday,Liverpool,0-2,0,2,1,1,2,-2,A,"Shankly, Bill",2,Away
1965-11-13,1965,Liverpool,Northampton Town,5-0,5,0,1,1,5,5,H,"Shankly, Bill",5,Anfield
1965-11-17,1965,Liverpool,Blackburn Rovers,5-2,5,2,1,1,7,3,H,"Shankly, Bill",5,Anfield
1965-11-20,1965,Stoke City,Liverpool,0-0,0,0,1,1,0,0,D,"Shankly, Bill",0,Away
1965-11-27,1965,Liverpool,Burnley,2-1,2,1,1,1,3,1,H,"Shankly, Bill",2,Anfield
1965-12-04,1965,Chelsea,Liverpool,0-1,0,1,1,1,1,-1,A,"Shankly, Bill",1,Away
1965-12-11,1965,Liverpool,Arsenal,4-2,4,2,1,1,6,2,H,"Shankly, Bill",4,Anfield
1965-12-18,1965,Newcastle United,Liverpool,0-0,0,0,1,1,0,0,D,"Shankly, Bill",0,Away
1965-12-27,1965,Liverpool,Leeds United,0-1,0,1,1,1,1,-1,A,"Shankly, Bill",0,Anfield
1965-12-28,1965,Leeds United,Liverpool,0-1,0,1,1,1,1,-1,A,"Shankly, Bill",1,Away
1966-01-01,1965,Liverpool,Manchester United,2-1,2,1,1,1,3,1,H,"Shankly, Bill",2,Anfield
1966-01-08,1965,Arsenal,Liverpool,0-1,0,1,1,1,1,-1,A,"Shankly, Bill",1,Away
1966-01-15,1965,Liverpool,West Bromwich Albion,2-2,2,2,1,1,4,0,D,"Shankly, Bill",2,Anfield
1966-01-29,1965,Liverpool,Leicester City,1-0,1,0,1,1,1,1,H,"Shankly, Bill",1,Anfield
1966-02-05,1965,Blackburn Rovers,Liverpool,1-4,1,4,1,1,5,-3,A,"Shankly, Bill",4,Away
1966-02-12,1965,Liverpool,Sunderland,4-0,4,0,1,1,4,4,H,"Shankly, Bill",4,Anfield
1966-02-19,1965,Liverpool,Blackpool,4-1,4,1,1,1,5,3,H,"Shankly, Bill",4,Anfield
1966-02-26,1965,Fulham,Liverpool,2-0,2,0,1,1,2,2,H,"Shankly, Bill",0,Away
1966-03-12,1965,Liverpool,Tottenham Hotspur,1-0,1,0,1,1,1,1,H,"Shankly, Bill",1,Anfield
1966-03-19,1965,Everton,Liverpool,0-0,0,0,1,1,0,0,D,"Shankly, Bill",0,Away
1966-03-26,1965,Aston Villa,Liverpool,0-3,0,3,1,1,3,-3,A,"Shankly, Bill",3,Away
1966-04-06,1965,Liverpool,Sheffield Wednesday,1-0,1,0,1,1,1,1,H,"Shankly, Bill",1,Anfield
1966-04-09,1965,Northampton Town,Liverpool,0-0,0,0,1,1,0,0,D,"Shankly, Bill",0,Away
1966-04-11,1965,Sunderland,Liverpool,2-2,2,2,1,1,4,0,D,"Shankly, Bill",2,Away
1966-04-16,1965,Liverpool,Stoke City,2-0,2,0,1,1,2,2,H,"Shankly, Bill",2,Anfield
1966-04-23,1965,Burnley,Liverpool,2-0,2,0,1,1,2,2,H,"Shankly, Bill",0,Away
1966-04-30,1965,Liverpool,Chelsea,2-1,2,1,1,1,3,1,H,"Shankly, Bill",2,Anfield
1966-05-10,1965,Nottingham Forest,Liverpool,1-1,1,1,1,1,2,0,D,"Shankly, Bill",1,Away
1966-08-20,1966,Liverpool,Leicester City,3-2,3,2,1,1,5,1,H,"Shankly, Bill",3,Anfield
1966-08-24,1966,Manchester City,Liverpool,2-1,2,1,1,1,3,1,H,"Shankly, Bill",1,Away
1966-08-27,1966,Everton,Liverpool,3-1,3,1,1,1,4,2,H,"Shankly, Bill",1,Away
1966-08-30,1966,Liverpool,Manchester City,3-2,3,2,1,1,5,1,H,"Shankly, Bill",3,Anfield
1966-09-03,1966,West Ham United,Liverpool,1-1,1,1,1,1,2,0,D,"Shankly, Bill",1,Away
1966-09-05,1966,Blackpool,Liverpool,1-2,1,2,1,1,3,-1,A,"Shankly, Bill",2,Away
1966-09-10,1966,Liverpool,Sheffield Wednesday,1-1,1,1,1,1,2,0,D,"Shankly, Bill",1,Anfield
1966-09-17,1966,Southampton,Liverpool,1-2,1,2,1,1,3,-1,A,"Shankly, Bill",2,Away
1966-09-24,1966,Liverpool,Sunderland,2-2,2,2,1,1,4,0,D,"Shankly, Bill",2,Anfield
1966-10-01,1966,Aston Villa,Liverpool,2-3,2,3,1,1,5,-1,A,"Shankly, Bill",3,Away
1966-10-08,1966,Liverpool,Fulham,2-2,2,2,1,1,4,0,D,"Shankly, Bill",2,Anfield
1966-10-15,1966,Nottingham Forest,Liverpool,1-1,1,1,1,1,2,0,D,"Shankly, Bill",1,Away
1966-10-29,1966,Stoke City,Liverpool,2-0,2,0,1,1,2,2,H,"Shankly, Bill",0,Away
1966-11-05,1966,Liverpool,Nottingham Forest,4-0,4,0,1,1,4,4,H,"Shankly, Bill",4,Anfield
1966-11-09,1966,Liverpool,Burnley,2-0,2,0,1,1,2,2,H,"Shankly, Bill",2,Anfield
1966-11-12,1966,Newcastle United,Liverpool,0-2,0,2,1,1,2,-2,A,"Shankly, Bill",2,Away
1966-11-19,1966,Liverpool,Leeds United,5-0,5,0,1,1,5,5,H,"Shankly, Bill",5,Anfield
1966-11-26,1966,West Bromwich Albion,Liverpool,2-1,2,1,1,1,3,1,H,"Shankly, Bill",1,Away
1966-12-03,1966,Liverpool,Sheffield United,1-0,1,0,1,1,1,1,H,"Shankly, Bill",1,Anfield
1966-12-10,1966,Manchester United,Liverpool,2-2,2,2,1,1,4,0,D,"Shankly, Bill",2,Away
1966-12-24,1966,Chelsea,Liverpool,1-2,1,2,1,1,3,-1,A,"Shankly, Bill",2,Away
1966-12-26,1966,Liverpool,Chelsea,2-1,2,1,1,1,3,1,H,"Shankly, Bill",2,Anfield
1966-12-31,1966,Liverpool,Everton,0-0,0,0,1,1,0,0,D,"Shankly, Bill",0,Anfield
1967-01-07,1966,Liverpool,West Ham United,2-0,2,0,1,1,2,2,H,"Shankly, Bill",2,Anfield
1967-01-14,1966,Sheffield Wednesday,Liverpool,0-1,0,1,1,1,1,-1,A,"Shankly, Bill",1,Away
1967-01-18,1966,Leicester City,Liverpool,2-1,2,1,1,1,3,1,H,"Shankly, Bill",1,Away
1967-01-21,1966,Liverpool,Southampton,2-1,2,1,1,1,3,1,H,"Shankly, Bill",2,Anfield
1967-02-04,1966,Sunderland,Liverpool,2-2,2,2,1,1,4,0,D,"Shankly, Bill",2,Away
1967-02-11,1966,Liverpool,Aston Villa,1-0,1,0,1,1,1,1,H,"Shankly, Bill",1,Anfield
1967-02-25,1966,Fulham,Liverpool,2-2,2,2,1,1,4,0,D,"Shankly, Bill",2,Away
1967-03-04,1966,Liverpool,Stoke City,2-1,2,1,1,1,3,1,H,"Shankly, Bill",2,Anfield
1967-03-18,1966,Burnley,Liverpool,1-0,1,0,1,1,1,1,H,"Shankly, Bill",0,Away
1967-03-25,1966,Liverpool,Manchester United,0-0,0,0,1,1,0,0,D,"Shankly, Bill",0,Anfield
1967-03-27,1966,Liverpool,Arsenal,0-0,0,0,1,1,0,0,D,"Shankly, Bill",0,Anfield
1967-03-28,1966,Arsenal,Liverpool,1-1,1,1,1,1,2,0,D,"Shankly, Bill",1,Away
1967-04-01,1966,Tottenham Hotspur,Liverpool,2-1,2,1,1,1,3,1,H,"Shankly, Bill",1,Away
1967-04-07,1966,Liverpool,Newcastle United,3-1,3,1,1,1,4,2,H,"Shankly, Bill",3,Anfield
1967-04-22,1966,Liverpool,West Bromwich Albion,0-1,0,1,1,1,1,-1,A,"Shankly, Bill",0,Anfield
1967-04-28,1966,Sheffield United,Liverpool,0-1,0,1,1,1,1,-1,A,"Shankly, Bill",1,Away
1967-05-03,1966,Leeds United,Liverpool,2-1,2,1,1,1,3,1,H,"Shankly, Bill",1,Away
1967-05-06,1966,Liverpool,Tottenham Hotspur,0-0,0,0,1,1,0,0,D,"Shankly, Bill",0,Anfield
1967-05-13,1966,Liverpool,Blackpool,1-3,1,3,1,1,4,-2,A,"Shankly, Bill",1,Anfield
1967-08-19,1967,Manchester City,Liverpool,0-0,0,0,1,1,0,0,D,"Shankly, Bill",0,Away
1967-08-22,1967,Liverpool,Arsenal,2-0,2,0,1,1,2,2,H,"Shankly, Bill",2,Anfield
1967-08-26,1967,Liverpool,Newcastle United,6-0,6,0,1,1,6,6,H,"Shankly, Bill",6,Anfield
1967-08-28,1967,Arsenal,Liverpool,2-0,2,0,1,1,2,2,H,"Shankly, Bill",0,Away
1967-09-02,1967,West Bromwich Albion,Liverpool,0-2,0,2,1,1,2,-2,A,"Shankly, Bill",2,Away
1967-09-05,1967,Nottingham Forest,Liverpool,0-1,0,1,1,1,1,-1,A,"Shankly, Bill",1,Away
1967-09-09,1967,Liverpool,Chelsea,3-1,3,1,1,1,4,2,H,"Shankly, Bill",3,Anfield
1967-09-16,1967,Southampton,Liverpool,1-0,1,0,1,1,1,1,H,"Shankly, Bill",0,Away
1967-09-23,1967,Liverpool,Everton,1-0,1,0,1,1,1,1,H,"Shankly, Bill",1,Anfield
1967-09-30,1967,Liverpool,Stoke City,2-1,2,1,1,1,3,1,H,"Shankly, Bill",2,Anfield
1967-10-07,1967,Leicester City,Liverpool,2-1,2,1,1,1,3,1,H,"Shankly, Bill",1,Away
1967-10-14,1967,Liverpool,West Ham United,3-1,3,1,1,1,4,2,H,"Shankly, Bill",3,Anfield
1967-10-24,1967,Burnley,Liverpool,1-1,1,1,1,1,2,0,D,"Shankly, Bill",1,Away
1967-10-28,1967,Liverpool,Sheffield Wednesday,1-0,1,0,1,1,1,1,H,"Shankly, Bill",1,Anfield
1967-11-04,1967,Tottenham Hotspur,Liverpool,1-1,1,1,1,1,2,0,D,"Shankly, Bill",1,Away
1967-11-11,1967,Liverpool,Manchester United,1-2,1,2,1,1,3,-1,A,"Shankly, Bill",1,Anfield
1967-11-18,1967,Sunderland,Liverpool,1-1,1,1,1,1,2,0,D,"Shankly, Bill",1,Away
1967-11-25,1967,Liverpool,Wolverhampton Wanderers,2-1,2,1,1,1,3,1,H,"Shankly, Bill",2,Anfield
1967-12-02,1967,Fulham,Liverpool,1-1,1,1,1,1,2,0,D,"Shankly, Bill",1,Away
1967-12-09,1967,Liverpool,Leeds United,2-0,2,0,1,1,2,2,H,"Shankly, Bill",2,Anfield
1967-12-16,1967,Liverpool,Manchester City,1-1,1,1,1,1,2,0,D,"Shankly, Bill",1,Anfield
1967-12-23,1967,Newcastle United,Liverpool,1-1,1,1,1,1,2,0,D,"Shankly, Bill",1,Away
1967-12-26,1967,Coventry City,Liverpool,1-1,1,1,1,1,2,0,D,"Shankly, Bill",1,Away
1967-12-30,1967,Liverpool,Coventry City,1-0,1,0,1,1,1,1,H,"Shankly, Bill",1,Anfield
1968-01-06,1967,Liverpool,West Bromwich Albion,4-1,4,1,1,1,5,3,H,"Shankly, Bill",4,Anfield
1968-01-20,1967,Liverpool,Southampton,2-0,2,0,1,1,2,2,H,"Shankly, Bill",2,Anfield
1968-02-03,1967,Everton,Liverpool,1-0,1,0,1,1,1,1,H,"Shankly, Bill",0,Away
1968-02-12,1967,Chelsea,Liverpool,3-1,3,1,1,1,4,2,H,"Shankly, Bill",1,Away
1968-02-24,1967,Liverpool,Leicester City,3-1,3,1,1,1,4,2,H,"Shankly, Bill",3,Anfield
1968-03-02,1967,Wolverhampton Wanderers,Liverpool,1-1,1,1,1,1,2,0,D,"Shankly, Bill",1,Away
1968-03-16,1967,Liverpool,Burnley,3-2,3,2,1,1,5,1,H,"Shankly, Bill",3,Anfield
1968-03-23,1967,Sheffield Wednesday,Liverpool,1-2,1,2,1,1,3,-1,A,"Shankly, Bill",2,Away
1968-04-06,1967,Manchester United,Liverpool,1-2,1,2,1,1,3,-1,A,"Shankly, Bill",2,Away
1968-04-12,1967,Liverpool,Sheffield United,1-2,1,2,1,1,3,-1,A,"Shankly, Bill",1,Anfield
1968-04-13,1967,Liverpool,Sunderland,2-1,2,1,1,1,3,1,H,"Shankly, Bill",2,Anfield
1968-04-15,1967,Sheffield United,Liverpool,1-1,1,1,1,1,2,0,D,"Shankly, Bill",1,Away
1968-04-20,1967,West Ham United,Liverpool,1-0,1,0,1,1,1,1,H,"Shankly, Bill",0,Away
1968-04-27,1967,Liverpool,Fulham,4-1,4,1,1,1,5,3,H,"Shankly, Bill",4,Anfield
1968-04-29,1967,Liverpool,Tottenham Hotspur,1-1,1,1,1,1,2,0,D,"Shankly, Bill",1,Anfield
1968-05-04,1967,Leeds United,Liverpool,1-2,1,2,1,1,3,-1,A,"Shankly, Bill",2,Away
1968-05-11,1967,Liverpool,Nottingham Forest,6-1,6,1,1,1,7,5,H,"Shankly, Bill",6,Anfield
1968-05-15,1967,Stoke City,Liverpool,2-1,2,1,1,1,3,1,H,"Shankly, Bill",1,Away
1968-08-10,1968,Liverpool,Manchester City,2-1,2,1,1,1,3,1,H,"Shankly, Bill",2,Anfield
1968-08-14,1968,Southampton,Liverpool,2-0,2,0,1,1,2,2,H,"Shankly, Bill",0,Away
1968-08-17,1968,Arsenal,Liverpool,1-1,1,1,1,1,2,0,D,"Shankly, Bill",1,Away
1968-08-20,1968,Liverpool,Stoke City,2-1,2,1,1,1,3,1,H,"Shankly, Bill",2,Anfield
1968-08-24,1968,Liverpool,Sunderland,4-1,4,1,1,1,5,3,H,"Shankly, Bill",4,Anfield
1968-08-27,1968,Everton,Liverpool,0-0,0,0,1,1,0,0,D,"Shankly, Bill",0,Away
1968-08-31,1968,Leeds United,Liverpool,1-0,1,0,1,1,1,1,H,"Shankly, Bill",0,Away
1968-09-07,1968,Liverpool,Queens Park Rangers,2-0,2,0,1,1,2,2,H,"Shankly, Bill",2,Anfield
1968-09-14,1968,Ipswich Town,Liverpool,0-2,0,2,1,1,2,-2,A,"Shankly, Bill",2,Away
1968-09-21,1968,Liverpool,Leicester City,4-0,4,0,1,1,4,4,H,"Shankly, Bill",4,Anfield
1968-09-28,1968,Wolverhampton Wanderers,Liverpool,0-6,0,6,1,1,6,-6,A,"Shankly, Bill",6,Away
1968-10-05,1968,Burnley,Liverpool,0-4,0,4,1,1,4,-4,A,"Shankly, Bill",4,Away
1968-10-08,1968,Liverpool,Everton,1-1,1,1,1,1,2,0,D,"Shankly, Bill",1,Anfield
1968-10-12,1968,Liverpool,Manchester United,2-0,2,0,1,1,2,2,H,"Shankly, Bill",2,Anfield
1968-10-19,1968,Tottenham Hotspur,Liverpool,2-1,2,1,1,1,3,1,H,"Shankly, Bill",1,Away
1968-10-26,1968,Liverpool,Newcastle United,2-1,2,1,1,1,3,1,H,"Shankly, Bill",2,Anfield
1968-11-02,1968,West Bromwich Albion,Liverpool,0-0,0,0,1,1,0,0,D,"Shankly, Bill",0,Away
1968-11-09,1968,Liverpool,Chelsea,2-1,2,1,1,1,3,1,H,"Shankly, Bill",2,Anfield
1968-11-16,1968,Sheffield Wednesday,Liverpool,1-2,1,2,1,1,3,-1,A,"Shankly, Bill",2,Away
1968-11-23,1968,Liverpool,Coventry City,2-0,2,0,1,1,2,2,H,"Shankly, Bill",2,Anfield
1968-11-30,1968,Nottingham Forest,Liverpool,0-1,0,1,1,1,1,-1,A,"Shankly, Bill",1,Away
1968-12-03,1968,Liverpool,Southampton,1-0,1,0,1,1,1,1,H,"Shankly, Bill",1,Anfield
1968-12-07,1968,Liverpool,West Ham United,2-0,2,0,1,1,2,2,H,"Shankly, Bill",2,Anfield
1968-12-14,1968,Manchester United,Liverpool,1-0,1,0,1,1,1,1,H,"Shankly, Bill",0,Away
1968-12-21,1968,Liverpool,Tottenham Hotspur,1-0,1,0,1,1,1,1,H,"Shankly, Bill",1,Anfield
1968-12-26,1968,Liverpool,Burnley,1-1,1,1,1,1,2,0,D,"Shankly, Bill",1,Anfield
1969-01-11,1968,Liverpool,West Bromwich Albion,1-0,1,0,1,1,1,1,H,"Shankly, Bill",1,Anfield
1969-01-18,1968,Chelsea,Liverpool,1-2,1,2,1,1,3,-1,A,"Shankly, Bill",2,Away
1969-02-01,1968,Liverpool,Sheffield Wednesday,1-0,1,0,1,1,1,1,H,"Shankly, Bill",1,Anfield
1969-02-15,1968,Liverpool,Nottingham Forest,0-2,0,2,1,1,2,-2,A,"Shankly, Bill",0,Anfield
1969-02-22,1968,West Ham United,Liverpool,1-1,1,1,1,1,2,0,D,"Shankly, Bill",1,Away
1969-03-15,1968,Sunderland,Liverpool,0-2,0,2,1,1,2,-2,A,"Shankly, Bill",2,Away
1969-03-29,1968,Queens Park Rangers,Liverpool,1-2,1,2,1,1,3,-1,A,"Shankly, Bill",2,Away
1969-03-31,1968,Liverpool,Arsenal,1-1,1,1,1,1,2,0,D,"Shankly, Bill",1,Anfield
1969-04-05,1968,Liverpool,Wolverhampton Wanderers,1-0,1,0,1,1,1,1,H,"Shankly, Bill",1,Anfield
1969-04-07,1968,Stoke City,Liverpool,0-0,0,0,1,1,0,0,D,"Shankly, Bill",0,Away
1969-04-12,1968,Leicester City,Liverpool,1-2,1,2,1,1,3,-1,A,"Shankly, Bill",2,Away
1969-04-19,1968,Liverpool,Ipswich Town,4-0,4,0,1,1,4,4,H,"Shankly, Bill",4,Anfield
1969-04-22,1968,Coventry City,Liverpool,0-0,0,0,1,1,0,0,D,"Shankly, Bill",0,Away
1969-04-28,1968,Liverpool,Leeds United,0-0,0,0,1,1,0,0,D,"Shankly, Bill",0,Anfield
1969-05-12,1968,Manchester City,Liverpool,1-0,1,0,1,1,1,1,H,"Shankly, Bill",0,Away
1969-05-17,1968,Newcastle United,Liverpool,1-1,1,1,1,1,2,0,D,"Shankly, Bill",1,Away
1969-08-09,1969,Liverpool,Chelsea,4-1,4,1,1,1,5,3,H,"Shankly, Bill",4,Anfield
1969-08-12,1969,Liverpool,Manchester City,3-2,3,2,1,1,5,1,H,"Shankly, Bill",3,Anfield
1969-08-16,1969,Tottenham Hotspur,Liverpool,0-2,0,2,1,1,2,-2,A,"Shankly, Bill",2,Away
1969-08-20,1969,Manchester City,Liverpool,0-2,0,2,1,1,2,-2,A,"Shankly, Bill",2,Away
1969-08-23,1969,Liverpool,Burnley,3-3,3,3,1,1,6,0,D,"Shankly, Bill",3,Anfield
1969-08-27,1969,Crystal Palace,Liverpool,1-3,1,3,1,1,4,-2,A,"Shankly, Bill",3,Away
1969-08-30,1969,Sheffield Wednesday,Liverpool,1-1,1,1,1,1,2,0,D,"Shankly, Bill",1,Away
1969-09-06,1969,Liverpool,Coventry City,2-1,2,1,1,1,3,1,H,"Shankly, Bill",2,Anfield
1969-09-09,1969,Liverpool,Sunderland,2-0,2,0,1,1,2,2,H,"Shankly, Bill",2,Anfield
1969-09-13,1969,Manchester United,Liverpool,1-0,1,0,1,1,1,1,H,"Shankly, Bill",0,Away
1969-09-20,1969,Liverpool,Stoke City,3-1,3,1,1,1,4,2,H,"Shankly, Bill",3,Anfield
1969-09-27,1969,West Bromwich Albion,Liverpool,2-2,2,2,1,1,4,0,D,"Shankly, Bill",2,Away
1969-10-04,1969,Liverpool,Nottingham Forest,1-1,1,1,1,1,2,0,D,"Shankly, Bill",1,Anfield
1969-10-07,1969,Liverpool,Tottenham Hotspur,0-0,0,0,1,1,0,0,D,"Shankly, Bill",0,Anfield
1969-10-11,1969,Newcastle United,Liverpool,1-0,1,0,1,1,1,1,H,"Shankly, Bill",0,Away
1969-10-18,1969,Ipswich Town,Liverpool,2-2,2,2,1,1,4,0,D,"Shankly, Bill",2,Away
1969-10-25,1969,Liverpool,Southampton,4-1,4,1,1,1,5,3,H,"Shankly, Bill",4,Anfield
1969-11-01,1969,Derby County,Liverpool,4-0,4,0,1,1,4,4,H,"Shankly, Bill",0,Away
1969-11-08,1969,Liverpool,Wolverhampton Wanderers,0-0,0,0,1,1,0,0,D,"Shankly, Bill",0,Anfield
1969-11-15,1969,Liverpool,West Ham United,2-0,2,0,1,1,2,2,H,"Shankly, Bill",2,Anfield
1969-11-22,1969,Leeds United,Liverpool,1-1,1,1,1,1,2,0,D,"Shankly, Bill",1,Away
1969-11-29,1969,Liverpool,Arsenal,0-1,0,1,1,1,1,-1,A,"Shankly, Bill",0,Anfield
1969-12-06,1969,Everton,Liverpool,0-3,0,3,1,1,3,-3,A,"Shankly, Bill",3,Away
1969-12-13,1969,Liverpool,Manchester United,1-4,1,4,1,1,5,-3,A,"Shankly, Bill",1,Anfield
1969-12-26,1969,Burnley,Liverpool,1-5,1,5,1,1,6,-4,A,"Shankly, Bill",5,Away
1970-01-10,1969,Stoke City,Liverpool,0-2,0,2,1,1,2,-2,A,"Shankly, Bill",2,Away
1970-01-17,1969,Liverpool,West Bromwich Albion,1-1,1,1,1,1,2,0,D,"Shankly, Bill",1,Anfield
1970-01-31,1969,Nottingham Forest,Liverpool,1-0,1,0,1,1,1,1,H,"Shankly, Bill",0,Away
1970-02-16,1969,Liverpool,Newcastle United,0-0,0,0,1,1,0,0,D,"Shankly, Bill",0,Anfield
1970-02-28,1969,Liverpool,Derby County,0-2,0,2,1,1,2,-2,A,"Shankly, Bill",0,Anfield
1970-03-03,1969,Coventry City,Liverpool,2-3,2,3,1,1,5,-1,A,"Shankly, Bill",3,Away
1970-03-07,1969,Liverpool,Leeds United,0-0,0,0,1,1,0,0,D,"Shankly, Bill",0,Anfield
1970-03-11,1969,Southampton,Liverpool,0-1,0,1,1,1,1,-1,A,"Shankly, Bill",1,Away
1970-03-14,1969,Arsenal,Liverpool,2-1,2,1,1,1,3,1,H,"Shankly, Bill",1,Away
1970-03-16,1969,Liverpool,Sheffield Wednesday,3-0,3,0,1,1,3,3,H,"Shankly, Bill",3,Anfield
1970-03-21,1969,Liverpool,Everton,0-2,0,2,1,1,2,-2,A,"Shankly, Bill",0,Anfield
1970-03-24,1969,Liverpool,Ipswich Town,2-0,2,0,1,1,2,2,H,"Shankly, Bill",2,Anfield
1970-03-28,1969,West Ham United,Liverpool,1-0,1,0,1,1,1,1,H,"Shankly, Bill",0,Away
1970-03-30,1969,Wolverhampton Wanderers,Liverpool,0-1,0,1,1,1,1,-1,A,"Shankly, Bill",1,Away
1970-04-03,1969,Liverpool,Crystal Palace,3-0,3,0,1,1,3,3,H,"Shankly, Bill",3,Anfield
1970-04-15,1969,Sunderland,Liverpool,0-1,0,1,1,1,1,-1,A,"Shankly, Bill",1,Away
1970-04-18,1969,Chelsea,Liverpool,2-1,2,1,1,1,3,1,H,"Shankly, Bill",1,Away
1970-08-15,1970,Burnley,Liverpool,1-2,1,2,1,1,3,-1,A,"Shankly, Bill",2,Away
1970-08-17,1970,Blackpool,Liverpool,0-0,0,0,1,1,0,0,D,"Shankly, Bill",0,Away
1970-08-22,1970,Liverpool,Huddersfield Town,4-0,4,0,1,1,4,4,H,"Shankly, Bill",4,Anfield
1970-08-25,1970,Liverpool,Crystal Palace,1-1,1,1,1,1,2,0,D,"Shankly, Bill",1,Anfield
1970-08-29,1970,West Bromwich Albion,Liverpool,1-1,1,1,1,1,2,0,D,"Shankly, Bill",1,Away
1970-09-05,1970,Liverpool,Manchester United,1-1,1,1,1,1,2,0,D,"Shankly, Bill",1,Anfield
1970-09-12,1970,Newcastle United,Liverpool,0-0,0,0,1,1,0,0,D,"Shankly, Bill",0,Away
1970-09-19,1970,Liverpool,Nottingham Forest,3-0,3,0,1,1,3,3,H,"Shankly, Bill",3,Anfield
1970-09-26,1970,Southampton,Liverpool,1-0,1,0,1,1,1,1,H,"Shankly, Bill",0,Away
1970-10-03,1970,Liverpool,Chelsea,1-0,1,0,1,1,1,1,H,"Shankly, Bill",1,Anfield
1970-10-10,1970,Tottenham Hotspur,Liverpool,1-0,1,0,1,1,1,1,H,"Shankly, Bill",0,Away
1970-10-17,1970,Liverpool,Burnley,2-0,2,0,1,1,2,2,H,"Shankly, Bill",2,Anfield
1970-10-24,1970,Ipswich Town,Liverpool,1-0,1,0,1,1,1,1,H,"Shankly, Bill",0,Away
1970-10-31,1970,Liverpool,Wolverhampton Wanderers,2-0,2,0,1,1,2,2,H,"Shankly, Bill",2,Anfield
1970-11-07,1970,Derby County,Liverpool,0-0,0,0,1,1,0,0,D,"Shankly, Bill",0,Away
1970-11-14,1970,Liverpool,Coventry City,0-0,0,0,1,1,0,0,D,"Shankly, Bill",0,Anfield
1970-11-21,1970,Liverpool,Everton,3-2,3,2,1,1,5,1,H,"Shankly, Bill",3,Anfield
1970-11-28,1970,Arsenal,Liverpool,2-0,2,0,1,1,2,2,H,"Shankly, Bill",0,Away
1970-12-05,1970,Liverpool,Leeds United,1-1,1,1,1,1,2,0,D,"Shankly, Bill",1,Anfield
1970-12-12,1970,West Ham United,Liverpool,1-2,1,2,1,1,3,-1,A,"Shankly, Bill",2,Away
1970-12-19,1970,Huddersfield Town,Liverpool,0-0,0,0,1,1,0,0,D,"Shankly, Bill",0,Away
1970-12-26,1970,Liverpool,Stoke City,0-0,0,0,1,1,0,0,D,"Shankly, Bill",0,Anfield
1971-01-09,1970,Liverpool,Blackpool,2-2,2,2,1,1,4,0,D,"Shankly, Bill",2,Anfield
1971-01-12,1970,Liverpool,Manchester City,0-0,0,0,1,1,0,0,D,"Shankly, Bill",0,Anfield
1971-01-16,1970,Crystal Palace,Liverpool,1-0,1,0,1,1,1,1,H,"Shankly, Bill",0,Away
1971-01-30,1970,Liverpool,Arsenal,2-0,2,0,1,1,2,2,H,"Shankly, Bill",2,Anfield
1971-02-06,1970,Leeds United,Liverpool,0-1,0,1,1,1,1,-1,A,"Shankly, Bill",1,Away
1971-02-16,1970,Liverpool,West Ham United,1-0,1,0,1,1,1,1,H,"Shankly, Bill",1,Anfield
1971-02-20,1970,Everton,Liverpool,0-0,0,0,1,1,0,0,D,"Shankly, Bill",0,Away
1971-02-27,1970,Wolverhampton Wanderers,Liverpool,1-0,1,0,1,1,1,1,H,"Shankly, Bill",0,Away
1971-03-13,1970,Coventry City,Liverpool,1-0,1,0,1,1,1,1,H,"Shankly, Bill",0,Away
1971-03-20,1970,Liverpool,Derby County,2-0,2,0,1,1,2,2,H,"Shankly, Bill",2,Anfield
1971-03-29,1970,Liverpool,Ipswich Town,2-1,2,1,1,1,3,1,H,"Shankly, Bill",2,Anfield
1971-04-02,1970,Liverpool,West Bromwich Albion,1-1,1,1,1,1,2,0,D,"Shankly, Bill",1,Anfield
1971-04-06,1970,Liverpool,Newcastle United,1-1,1,1,1,1,2,0,D,"Shankly, Bill",1,Anfield
1971-04-10,1970,Stoke City,Liverpool,0-1,0,1,1,1,1,-1,A,"Shankly, Bill",1,Away
1971-04-12,1970,Chelsea,Liverpool,1-0,1,0,1,1,1,1,H,"Shankly, Bill",0,Away
1971-04-17,1970,Liverpool,Tottenham Hotspur,0-0,0,0,1,1,0,0,D,"Shankly, Bill",0,Anfield
1971-04-19,1970,Manchester United,Liverpool,0-2,0,2,1,1,2,-2,A,"Shankly, Bill",2,Away
1971-04-24,1970,Nottingham Forest,Liverpool,0-1,0,1,1,1,1,-1,A,"Shankly, Bill",1,Away
1971-04-26,1970,Manchester City,Liverpool,2-2,2,2,1,1,4,0,D,"Shankly, Bill",2,Away
1971-05-01,1970,Liverpool,Southampton,1-0,1,0,1,1,1,1,H,"Shankly, Bill",1,Anfield
1971-08-14,1971,Liverpool,Nottingham Forest,3-1,3,1,1,1,4,2,H,"Shankly, Bill",3,Anfield
1971-08-17,1971,Liverpool,Wolverhampton Wanderers,3-2,3,2,1,1,5,1,H,"Shankly, Bill",3,Anfield
1971-08-21,1971,Newcastle United,Liverpool,3-2,3,2,1,1,5,1,H,"Shankly, Bill",2,Away
1971-08-24,1971,Crystal Palace,Liverpool,0-1,0,1,1,1,1,-1,A,"Shankly, Bill",1,Away
1971-08-28,1971,Liverpool,Leicester City,3-2,3,2,1,1,5,1,H,"Shankly, Bill",3,Anfield
1971-09-01,1971,Manchester City,Liverpool,1-0,1,0,1,1,1,1,H,"Shankly, Bill",0,Away
1971-09-04,1971,Tottenham Hotspur,Liverpool,2-0,2,0,1,1,2,2,H,"Shankly, Bill",0,Away
1971-09-11,1971,Liverpool,Southampton,1-0,1,0,1,1,1,1,H,"Shankly, Bill",1,Anfield
1971-09-18,1971,Leeds United,Liverpool,1-0,1,0,1,1,1,1,H,"Shankly, Bill",0,Away
1971-09-25,1971,Liverpool,Manchester United,2-2,2,2,1,1,4,0,D,"Shankly, Bill",2,Anfield
1971-10-02,1971,Stoke City,Liverpool,0-0,0,0,1,1,0,0,D,"Shankly, Bill",0,Away
1971-10-09,1971,Liverpool,Chelsea,0-0,0,0,1,1,0,0,D,"Shankly, Bill",0,Anfield
1971-10-16,1971,Nottingham Forest,Liverpool,2-3,2,3,1,1,5,-1,A,"Shankly, Bill",3,Away
1971-10-23,1971,Liverpool,Huddersfield Town,2-0,2,0,1,1,2,2,H,"Shankly, Bill",2,Anfield
1971-10-30,1971,Sheffield United,Liverpool,1-1,1,1,1,1,2,0,D,"Shankly, Bill",1,Away
1971-11-06,1971,Liverpool,Arsenal,3-2,3,2,1,1,5,1,H,"Shankly, Bill",3,Anfield
1971-11-13,1971,Everton,Liverpool,1-0,1,0,1,1,1,1,H,"Shankly, Bill",0,Away
1971-11-20,1971,Coventry City,Liverpool,0-2,0,2,1,1,2,-2,A,"Shankly, Bill",2,Away
1971-11-27,1971,Liverpool,West Ham United,1-0,1,0,1,1,1,1,H,"Shankly, Bill",1,Anfield
1971-12-04,1971,Ipswich Town,Liverpool,0-0,0,0,1,1,0,0,D,"Shankly, Bill",0,Away
1971-12-11,1971,Liverpool,Derby County,3-2,3,2,1,1,5,1,H,"Shankly, Bill",3,Anfield
1971-12-18,1971,Liverpool,Tottenham Hotspur,0-0,0,0,1,1,0,0,D,"Shankly, Bill",0,Anfield
1971-12-27,1971,West Bromwich Albion,Liverpool,1-0,1,0,1,1,1,1,H,"Shankly, Bill",0,Away
1972-01-01,1971,Liverpool,Leeds United,0-2,0,2,1,1,2,-2,A,"Shankly, Bill",0,Anfield
1972-01-08,1971,Leicester City,Liverpool,1-0,1,0,1,1,1,1,H,"Shankly, Bill",0,Away
1972-01-22,1971,Wolverhampton Wanderers,Liverpool,0-0,0,0,1,1,0,0,D,"Shankly, Bill",0,Away
1972-01-29,1971,Liverpool,Crystal Palace,4-1,4,1,1,1,5,3,H,"Shankly, Bill",4,Anfield
1972-02-12,1971,Huddersfield Town,Liverpool,0-1,0,1,1,1,1,-1,A,"Shankly, Bill",1,Away
1972-02-19,1971,Liverpool,Sheffield United,2-0,2,0,1,1,2,2,H,"Shankly, Bill",2,Anfield
1972-02-26,1971,Liverpool,Manchester City,3-0,3,0,1,1,3,3,H,"Shankly, Bill",3,Anfield
1972-03-04,1971,Liverpool,Everton,4-0,4,0,1,1,4,4,H,"Shankly, Bill",4,Anfield
1972-03-11,1971,Chelsea,Liverpool,0-0,0,0,1,1,0,0,D,"Shankly, Bill",0,Away
1972-03-18,1971,Liverpool,Newcastle United,5-0,5,0,1,1,5,5,H,"Shankly, Bill",5,Anfield
1972-03-25,1971,Southampton,Liverpool,0-1,0,1,1,1,1,-1,A,"Shankly, Bill",1,Away
1972-03-28,1971,Liverpool,Stoke City,2-1,2,1,1,1,3,1,H,"Shankly, Bill",2,Anfield
1972-04-01,1971,Liverpool,West Bromwich Albion,2-0,2,0,1,1,2,2,H,"Shankly, Bill",2,Anfield
1972-04-03,1971,Manchester United,Liverpool,0-3,0,3,1,1,3,-3,A,"Shankly, Bill",3,Away
1972-04-08,1971,Liverpool,Coventry City,3-1,3,1,1,1,4,2,H,"Shankly, Bill",3,Anfield
1972-04-15,1971,West Ham United,Liverpool,0-2,0,2,1,1,2,-2,A,"Shankly, Bill",2,Away
1972-04-22,1971,Liverpool,Ipswich Town,2-0,2,0,1,1,2,2,H,"Shankly, Bill",2,Anfield
1972-05-01,1971,Derby County,Liverpool,1-0,1,0,1,1,1,1,H,"Shankly, Bill",0,Away
1972-05-08,1971,Arsenal,Liverpool,0-0,0,0,1,1,0,0,D,"Shankly, Bill",0,Away
1972-08-12,1972,Liverpool,Manchester City,2-0,2,0,1,1,2,2,H,"Shankly, Bill",2,Anfield
1972-08-15,1972,Liverpool,Manchester United,2-0,2,0,1,1,2,2,H,"Shankly, Bill",2,Anfield
1972-08-19,1972,Crystal Palace,Liverpool,1-1,1,1,1,1,2,0,D,"Shankly, Bill",1,Away
1972-08-23,1972,Chelsea,Liverpool,1-2,1,2,1,1,3,-1,A,"Shankly, Bill",2,Away
1972-08-26,1972,Liverpool,West Ham United,3-2,3,2,1,1,5,1,H,"Shankly, Bill",3,Anfield
1972-08-30,1972,Leicester City,Liverpool,3-2,3,2,1,1,5,1,H,"Shankly, Bill",2,Away
1972-09-02,1972,Derby County,Liverpool,2-1,2,1,1,1,3,1,H,"Shankly, Bill",1,Away
1972-09-09,1972,Liverpool,Wolverhampton Wanderers,4-2,4,2,1,1,6,2,H,"Shankly, Bill",4,Anfield
1972-09-16,1972,Arsenal,Liverpool,0-0,0,0,1,1,0,0,D,"Shankly, Bill",0,Away
1972-09-23,1972,Liverpool,Sheffield United,5-0,5,0,1,1,5,5,H,"Shankly, Bill",5,Anfield
1972-09-30,1972,Leeds United,Liverpool,1-2,1,2,1,1,3,-1,A,"Shankly, Bill",2,Away
1972-10-07,1972,Liverpool,Everton,1-0,1,0,1,1,1,1,H,"Shankly, Bill",1,Anfield
1972-10-14,1972,Southampton,Liverpool,1-1,1,1,1,1,2,0,D,"Shankly, Bill",1,Away
1972-10-21,1972,Liverpool,Stoke City,2-1,2,1,1,1,3,1,H,"Shankly, Bill",2,Anfield
1972-10-28,1972,Norwich City,Liverpool,1-1,1,1,1,1,2,0,D,"Shankly, Bill",1,Away
1972-11-04,1972,Liverpool,Chelsea,3-1,3,1,1,1,4,2,H,"Shankly, Bill",3,Anfield
1972-11-11,1972,Manchester United,Liverpool,2-0,2,0,1,1,2,2,H,"Shankly, Bill",0,Away
1972-11-18,1972,Liverpool,Newcastle United,3-2,3,2,1,1,5,1,H,"Shankly, Bill",3,Anfield
1972-11-25,1972,Tottenham Hotspur,Liverpool,1-2,1,2,1,1,3,-1,A,"Shankly, Bill",2,Away
1972-12-02,1972,Liverpool,Birmingham City,4-3,4,3,1,1,7,1,H,"Shankly, Bill",4,Anfield
1972-12-09,1972,West Bromwich Albion,Liverpool,1-1,1,1,1,1,2,0,D,"Shankly, Bill",1,Away
1972-12-16,1972,Ipswich Town,Liverpool,1-1,1,1,1,1,2,0,D,"Shankly, Bill",1,Away
1972-12-23,1972,Liverpool,Coventry City,2-0,2,0,1,1,2,2,H,"Shankly, Bill",2,Anfield
1972-12-26,1972,Sheffield United,Liverpool,0-3,0,3,1,1,3,-3,A,"Shankly, Bill",3,Away
1972-12-30,1972,Liverpool,Crystal Palace,1-0,1,0,1,1,1,1,H,"Shankly, Bill",1,Anfield
1973-01-06,1972,West Ham United,Liverpool,0-1,0,1,1,1,1,-1,A,"Shankly, Bill",1,Away
1973-01-20,1972,Liverpool,Derby County,1-1,1,1,1,1,2,0,D,"Shankly, Bill",1,Anfield
1973-01-27,1972,Wolverhampton Wanderers,Liverpool,2-1,2,1,1,1,3,1,H,"Shankly, Bill",1,Away
1973-02-10,1972,Liverpool,Arsenal,0-2,0,2,1,1,2,-2,A,"Shankly, Bill",0,Anfield
1973-02-17,1972,Manchester City,Liverpool,1-1,1,1,1,1,2,0,D,"Shankly, Bill",1,Away
1973-02-24,1972,Liverpool,Ipswich Town,2-1,2,1,1,1,3,1,H,"Shankly, Bill",2,Anfield
1973-03-03,1972,Everton,Liverpool,0-2,0,2,1,1,2,-2,A,"Shankly, Bill",2,Away
1973-03-10,1972,Liverpool,Southampton,3-2,3,2,1,1,5,1,H,"Shankly, Bill",3,Anfield
1973-03-17,1972,Stoke City,Liverpool,0-1,0,1,1,1,1,-1,A,"Shankly, Bill",1,Away
1973-03-24,1972,Liverpool,Norwich City,3-1,3,1,1,1,4,2,H,"Shankly, Bill",3,Anfield
1973-03-31,1972,Liverpool,Tottenham Hotspur,1-1,1,1,1,1,2,0,D,"Shankly, Bill",1,Anfield
1973-04-07,1972,Birmingham City,Liverpool,2-1,2,1,1,1,3,1,H,"Shankly, Bill",1,Away
1973-04-14,1972,Liverpool,West Bromwich Albion,1-0,1,0,1,1,1,1,H,"Shankly, Bill",1,Anfield
1973-04-17,1972,Coventry City,Liverpool,1-2,1,2,1,1,3,-1,A,"Shankly, Bill",2,Away
1973-04-21,1972,Newcastle United,Liverpool,2-1,2,1,1,1,3,1,H,"Shankly, Bill",1,Away
1973-04-23,1972,Liverpool,Leeds United,2-0,2,0,1,1,2,2,H,"Shankly, Bill",2,Anfield
1973-04-28,1972,Liverpool,Leicester City,0-0,0,0,1,1,0,0,D,"Shankly, Bill",0,Anfield
1973-08-25,1973,Liverpool,Stoke City,1-0,1,0,1,1,1,1,H,"Shankly, Bill",1,Anfield
1973-08-28,1973,Coventry City,Liverpool,1-0,1,0,1,1,1,1,H,"Shankly, Bill",0,Away
1973-09-01,1973,Leicester City,Liverpool,1-1,1,1,1,1,2,0,D,"Shankly, Bill",1,Away
1973-09-04,1973,Liverpool,Derby County,2-0,2,0,1,1,2,2,H,"Shankly, Bill",2,Anfield
1973-09-08,1973,Liverpool,Chelsea,1-0,1,0,1,1,1,1,H,"Shankly, Bill",1,Anfield
1973-09-12,1973,Derby County,Liverpool,3-1,3,1,1,1,4,2,H,"Shankly, Bill",1,Away
1973-09-15,1973,Birmingham City,Liverpool,1-1,1,1,1,1,2,0,D,"Shankly, Bill",1,Away
1973-09-22,1973,Liverpool,Tottenham Hotspur,3-2,3,2,1,1,5,1,H,"Shankly, Bill",3,Anfield
1973-09-29,1973,Manchester United,Liverpool,0-0,0,0,1,1,0,0,D,"Shankly, Bill",0,Away
1973-10-06,1973,Liverpool,Newcastle United,2-1,2,1,1,1,3,1,H,"Shankly, Bill",2,Anfield
1973-10-13,1973,Southampton,Liverpool,1-0,1,0,1,1,1,1,H,"Shankly, Bill",0,Away
1973-10-20,1973,Leeds United,Liverpool,1-0,1,0,1,1,1,1,H,"Shankly, Bill",0,Away
1973-10-27,1973,Liverpool,Sheffield United,1-0,1,0,1,1,1,1,H,"Shankly, Bill",1,Anfield
1973-11-03,1973,Arsenal,Liverpool,0-2,0,2,1,1,2,-2,A,"Shankly, Bill",2,Away
1973-11-10,1973,Liverpool,Wolverhampton Wanderers,1-0,1,0,1,1,1,1,H,"Shankly, Bill",1,Anfield
1973-11-17,1973,Liverpool,Ipswich Town,4-2,4,2,1,1,6,2,H,"Shankly, Bill",4,Anfield
1973-11-24,1973,Queens Park Rangers,Liverpool,2-2,2,2,1,1,4,0,D,"Shankly, Bill",2,Away
1973-12-01,1973,Liverpool,West Ham United,1-0,1,0,1,1,1,1,H,"Shankly, Bill",1,Anfield
1973-12-08,1973,Everton,Liverpool,0-1,0,1,1,1,1,-1,A,"Shankly, Bill",1,Away
1973-12-15,1973,Norwich City,Liverpool,1-1,1,1,1,1,2,0,D,"Shankly, Bill",1,Away
1973-12-22,1973,Liverpool,Manchester United,2-0,2,0,1,1,2,2,H,"Shankly, Bill",2,Anfield
1973-12-26,1973,Burnley,Liverpool,2-1,2,1,1,1,3,1,H,"Shankly, Bill",1,Away
1973-12-29,1973,Chelsea,Liverpool,0-1,0,1,1,1,1,-1,A,"Shankly, Bill",1,Away
1974-01-01,1973,Liverpool,Leicester City,1-1,1,1,1,1,2,0,D,"Shankly, Bill",1,Anfield
1974-01-12,1973,Liverpool,Birmingham City,3-2,3,2,1,1,5,1,H,"Shankly, Bill",3,Anfield
1974-01-19,1973,Stoke City,Liverpool,1-1,1,1,1,1,2,0,D,"Shankly, Bill",1,Away
1974-02-02,1973,Liverpool,Norwich City,1-0,1,0,1,1,1,1,H,"Shankly, Bill",1,Anfield
1974-02-05,1973,Liverpool,Coventry City,2-1,2,1,1,1,3,1,H,"Shankly, Bill",2,Anfield
1974-02-23,1973,Newcastle United,Liverpool,0-0,0,0,1,1,0,0,D,"Shankly, Bill",0,Away
1974-02-26,1973,Liverpool,Southampton,1-0,1,0,1,1,1,1,H,"Shankly, Bill",1,Anfield
1974-03-02,1973,Liverpool,Burnley,1-0,1,0,1,1,1,1,H,"Shankly, Bill",1,Anfield
1974-03-16,1973,Liverpool,Leeds United,1-0,1,0,1,1,1,1,H,"Shankly, Bill",1,Anfield
1974-03-23,1973,Wolverhampton Wanderers,Liverpool,0-1,0,1,1,1,1,-1,A,"Shankly, Bill",1,Away
1974-04-06,1973,Liverpool,Queens Park Rangers,2-1,2,1,1,1,3,1,H,"Shankly, Bill",2,Anfield
1974-04-08,1973,Sheffield United,Liverpool,1-0,1,0,1,1,1,1,H,"Shankly, Bill",0,Away
1974-04-12,1973,Manchester City,Liverpool,1-1,1,1,1,1,2,0,D,"Shankly, Bill",1,Away
1974-04-13,1973,Ipswich Town,Liverpool,1-1,1,1,1,1,2,0,D,"Shankly, Bill",1,Away
1974-04-16,1973,Liverpool,Manchester City,4-0,4,0,1,1,4,4,H,"Shankly, Bill",4,Anfield
1974-04-20,1973,Liverpool,Everton,0-0,0,0,1,1,0,0,D,"Shankly, Bill",0,Anfield
1974-04-24,1973,Liverpool,Arsenal,0-1,0,1,1,1,1,-1,A,"Shankly, Bill",0,Anfield
1974-04-27,1973,West Ham United,Liverpool,2-2,2,2,1,1,4,0,D,"Shankly, Bill",2,Away
1974-05-08,1973,Tottenham Hotspur,Liverpool,1-1,1,1,1,1,2,0,D,"Shankly, Bill",1,Away
1974-08-17,1974,Luton Town,Liverpool,1-2,1,2,1,1,3,-1,A,,2,Away
1974-08-20,1974,Wolverhampton Wanderers,Liverpool,0-0,0,0,1,1,0,0,D,,0,Away
1974-08-24,1974,Liverpool,Leicester City,2-1,2,1,1,1,3,1,H,,2,Anfield
1974-08-27,1974,Liverpool,Wolverhampton Wanderers,2-0,2,0,1,1,2,2,H,"Paisley, Bob",2,Anfield
1974-08-31,1974,Chelsea,Liverpool,0-3,0,3,1,1,3,-3,A,"Paisley, Bob",3,Away
1974-09-07,1974,Liverpool,Tottenham Hotspur,5-2,5,2,1,1,7,3,H,"Paisley, Bob",5,Anfield
1974-09-14,1974,Manchester City,Liverpool,2-0,2,0,1,1,2,2,H,"Paisley, Bob",0,Away
1974-09-21,1974,Liverpool,Stoke City,3-0,3,0,1,1,3,3,H,"Paisley, Bob",3,Anfield
1974-09-24,1974,Liverpool,Burnley,0-1,0,1,1,1,1,-1,A,"Paisley, Bob",0,Anfield
1974-09-28,1974,Sheffield United,Liverpool,1-0,1,0,1,1,1,1,H,"Paisley, Bob",0,Away
1974-10-05,1974,Carlisle United,Liverpool,0-1,0,1,1,1,1,-1,A,"Paisley, Bob",1,Away
1974-10-12,1974,Liverpool,Middlesbrough,2-0,2,0,1,1,2,2,H,"Paisley, Bob",2,Anfield
1974-10-19,1974,Queens Park Rangers,Liverpool,0-1,0,1,1,1,1,-1,A,"Paisley, Bob",1,Away
1974-10-26,1974,Liverpool,Leeds United,1-0,1,0,1,1,1,1,H,"Paisley, Bob",1,Anfield
1974-11-02,1974,Ipswich Town,Liverpool,1-0,1,0,1,1,1,1,H,"Paisley, Bob",0,Away
1974-11-09,1974,Liverpool,Arsenal,1-3,1,3,1,1,4,-2,A,"Paisley, Bob",1,Anfield
1974-11-16,1974,Everton,Liverpool,0-0,0,0,1,1,0,0,D,"Paisley, Bob",0,Away
1974-11-23,1974,Liverpool,West Ham United,1-1,1,1,1,1,2,0,D,"Paisley, Bob",1,Anfield
1974-11-30,1974,Coventry City,Liverpool,1-1,1,1,1,1,2,0,D,"Paisley, Bob",1,Away
1974-12-07,1974,Liverpool,Derby County,2-2,2,2,1,1,4,0,D,"Paisley, Bob",2,Anfield
1974-12-14,1974,Liverpool,Luton Town,2-0,2,0,1,1,2,2,H,"Paisley, Bob",2,Anfield
1974-12-21,1974,Birmingham City,Liverpool,3-1,3,1,1,1,4,2,H,"Paisley, Bob",1,Away
1974-12-26,1974,Liverpool,Manchester City,4-1,4,1,1,1,5,3,H,"Paisley, Bob",4,Anfield
1975-01-11,1974,Derby County,Liverpool,2-0,2,0,1,1,2,2,H,"Paisley, Bob",0,Away
1975-01-18,1974,Liverpool,Coventry City,2-1,2,1,1,1,3,1,H,"Paisley, Bob",2,Anfield
1975-02-01,1974,Arsenal,Liverpool,2-0,2,0,1,1,2,2,H,"Paisley, Bob",0,Away
1975-02-08,1974,Liverpool,Ipswich Town,5-2,5,2,1,1,7,3,H,"Paisley, Bob",5,Anfield
1975-02-12,1974,Newcastle United,Liverpool,4-1,4,1,1,1,5,3,H,"Paisley, Bob",1,Away
1975-02-19,1974,West Ham United,Liverpool,0-0,0,0,1,1,0,0,D,"Paisley, Bob",0,Away
1975-02-22,1974,Liverpool,Everton,0-0,0,0,1,1,0,0,D,"Paisley, Bob",0,Anfield
1975-03-01,1974,Liverpool,Chelsea,2-2,2,2,1,1,4,0,D,"Paisley, Bob",2,Anfield
1975-03-08,1974,Burnley,Liverpool,1-1,1,1,1,1,2,0,D,"Paisley, Bob",1,Away
1975-03-15,1974,Liverpool,Sheffield United,0-0,0,0,1,1,0,0,D,"Paisley, Bob",0,Anfield
1975-03-19,1974,Leicester City,Liverpool,1-1,1,1,1,1,2,0,D,"Paisley, Bob",1,Away
1975-03-22,1974,Tottenham Hotspur,Liverpool,0-2,0,2,1,1,2,-2,A,"Paisley, Bob",2,Away
1975-03-25,1974,Liverpool,Newcastle United,4-0,4,0,1,1,4,4,H,"Paisley, Bob",4,Anfield
1975-03-29,1974,Liverpool,Birmingham City,1-0,1,0,1,1,1,1,H,"Paisley, Bob",1,Anfield
1975-03-31,1974,Stoke City,Liverpool,2-0,2,0,1,1,2,2,H,"Paisley, Bob",0,Away
1975-04-05,1974,Leeds United,Liverpool,0-2,0,2,1,1,2,-2,A,"Paisley, Bob",2,Away
1975-04-12,1974,Liverpool,Carlisle United,2-0,2,0,1,1,2,2,H,"Paisley, Bob",2,Anfield
1975-04-19,1974,Middlesbrough,Liverpool,1-0,1,0,1,1,1,1,H,"Paisley, Bob",0,Away
1975-04-26,1974,Liverpool,Queens Park Rangers,3-1,3,1,1,1,4,2,H,"Paisley, Bob",3,Anfield
1975-08-16,1975,Queens Park Rangers,Liverpool,2-0,2,0,1,1,2,2,H,"Paisley, Bob",0,Away
1975-08-19,1975,Liverpool,West Ham United,2-2,2,2,1,1,4,0,D,"Paisley, Bob",2,Anfield
1975-08-23,1975,Liverpool,Tottenham Hotspur,3-2,3,2,1,1,5,1,H,"Paisley, Bob",3,Anfield
1975-08-26,1975,Leeds United,Liverpool,0-3,0,3,1,1,3,-3,A,"Paisley, Bob",3,Away
1975-08-30,1975,Leicester City,Liverpool,1-1,1,1,1,1,2,0,D,"Paisley, Bob",1,Away
1975-09-06,1975,Liverpool,Sheffield United,1-0,1,0,1,1,1,1,H,"Paisley, Bob",1,Anfield
1975-09-13,1975,Ipswich Town,Liverpool,2-0,2,0,1,1,2,2,H,"Paisley, Bob",0,Away
1975-09-20,1975,Liverpool,Aston Villa,3-0,3,0,1,1,3,3,H,"Paisley, Bob",3,Anfield
1975-09-27,1975,Everton,Liverpool,0-0,0,0,1,1,0,0,D,"Paisley, Bob",0,Away
1975-10-04,1975,Liverpool,Wolverhampton Wanderers,2-0,2,0,1,1,2,2,H,"Paisley, Bob",2,Anfield
1975-10-11,1975,Liverpool,Birmingham City,3-1,3,1,1,1,4,2,H,"Paisley, Bob",3,Anfield
1975-10-18,1975,Coventry City,Liverpool,0-0,0,0,1,1,0,0,D,"Paisley, Bob",0,Away
1975-10-25,1975,Liverpool,Derby County,1-1,1,1,1,1,2,0,D,"Paisley, Bob",1,Anfield
1975-11-01,1975,Middlesbrough,Liverpool,0-1,0,1,1,1,1,-1,A,"Paisley, Bob",1,Away
1975-11-08,1975,Liverpool,Manchester United,3-1,3,1,1,1,4,2,H,"Paisley, Bob",3,Anfield
1975-11-15,1975,Newcastle United,Liverpool,1-2,1,2,1,1,3,-1,A,"Paisley, Bob",2,Away
1975-11-22,1975,Liverpool,Coventry City,1-1,1,1,1,1,2,0,D,"Paisley, Bob",1,Anfield
1975-11-29,1975,Liverpool,Norwich City,1-3,1,3,1,1,4,-2,A,"Paisley, Bob",1,Anfield
1975-12-02,1975,Liverpool,Arsenal,2-2,2,2,1,1,4,0,D,"Paisley, Bob",2,Anfield
1975-12-06,1975,Burnley,Liverpool,0-0,0,0,1,1,0,0,D,"Paisley, Bob",0,Away
1975-12-13,1975,Tottenham Hotspur,Liverpool,0-4,0,4,1,1,4,-4,A,"Paisley, Bob",4,Away
1975-12-20,1975,Liverpool,Queens Park Rangers,2-0,2,0,1,1,2,2,H,"Paisley, Bob",2,Anfield
1975-12-26,1975,Stoke City,Liverpool,1-1,1,1,1,1,2,0,D,"Paisley, Bob",1,Away
1975-12-27,1975,Liverpool,Manchester City,1-0,1,0,1,1,1,1,H,"Paisley, Bob",1,Anfield
1976-01-10,1975,Liverpool,Ipswich Town,3-3,3,3,1,1,6,0,D,"Paisley, Bob",3,Anfield
1976-01-17,1975,Sheffield United,Liverpool,0-0,0,0,1,1,0,0,D,"Paisley, Bob",0,Away
1976-01-31,1975,West Ham United,Liverpool,0-4,0,4,1,1,4,-4,A,"Paisley, Bob",4,Away
1976-02-07,1975,Liverpool,Leeds United,2-0,2,0,1,1,2,2,H,"Paisley, Bob",2,Anfield
1976-02-18,1975,Manchester United,Liverpool,0-0,0,0,1,1,0,0,D,"Paisley, Bob",0,Away
1976-02-21,1975,Liverpool,Newcastle United,2-0,2,0,1,1,2,2,H,"Paisley, Bob",2,Anfield
1976-02-24,1975,Arsenal,Liverpool,1-0,1,0,1,1,1,1,H,"Paisley, Bob",0,Away
1976-02-28,1975,Derby County,Liverpool,1-1,1,1,1,1,2,0,D,"Paisley, Bob",1,Away
1976-03-06,1975,Liverpool,Middlesbrough,0-2,0,2,1,1,2,-2,A,"Paisley, Bob",0,Anfield
1976-03-13,1975,Birmingham City,Liverpool,0-1,0,1,1,1,1,-1,A,"Paisley, Bob",1,Away
1976-03-20,1975,Norwich City,Liverpool,0-1,0,1,1,1,1,-1,A,"Paisley, Bob",1,Away
1976-03-27,1975,Liverpool,Burnley,2-0,2,0,1,1,2,2,H,"Paisley, Bob",2,Anfield
1976-04-03,1975,Liverpool,Everton,1-0,1,0,1,1,1,1,H,"Paisley, Bob",1,Anfield
1976-04-06,1975,Liverpool,Leicester City,1-0,1,0,1,1,1,1,H,"Paisley, Bob",1,Anfield
1976-04-10,1975,Aston Villa,Liverpool,0-0,0,0,1,1,0,0,D,"Paisley, Bob",0,Away
1976-04-17,1975,Liverpool,Stoke City,5-3,5,3,1,1,8,2,H,"Paisley, Bob",5,Anfield
1976-04-19,1975,Manchester City,Liverpool,0-3,0,3,1,1,3,-3,A,"Paisley, Bob",3,Away
1976-05-04,1975,Wolverhampton Wanderers,Liverpool,1-3,1,3,1,1,4,-2,A,"Paisley, Bob",3,Away
1976-08-21,1976,Liverpool,Norwich City,1-0,1,0,1,1,1,1,H,"Paisley, Bob",1,Anfield
1976-08-25,1976,West Bromwich Albion,Liverpool,0-1,0,1,1,1,1,-1,A,"Paisley, Bob",1,Away
1976-08-28,1976,Birmingham City,Liverpool,2-1,2,1,1,1,3,1,H,"Paisley, Bob",1,Away
1976-09-04,1976,Liverpool,Coventry City,3-1,3,1,1,1,4,2,H,"Paisley, Bob",3,Anfield
1976-09-11,1976,Derby County,Liverpool,2-3,2,3,1,1,5,-1,A,"Paisley, Bob",3,Away
1976-09-18,1976,Liverpool,Tottenham Hotspur,2-0,2,0,1,1,2,2,H,"Paisley, Bob",2,Anfield
1976-09-25,1976,Newcastle United,Liverpool,1-0,1,0,1,1,1,1,H,"Paisley, Bob",0,Away
1976-10-02,1976,Liverpool,Middlesbrough,0-0,0,0,1,1,0,0,D,"Paisley, Bob",0,Anfield
1976-10-16,1976,Liverpool,Everton,3-1,3,1,1,1,4,2,H,"Paisley, Bob",3,Anfield
1976-10-23,1976,Leeds United,Liverpool,1-1,1,1,1,1,2,0,D,"Paisley, Bob",1,Away
1976-10-27,1976,Leicester City,Liverpool,0-1,0,1,1,1,1,-1,A,"Paisley, Bob",1,Away
1976-10-30,1976,Liverpool,Aston Villa,3-0,3,0,1,1,3,3,H,"Paisley, Bob",3,Anfield
1976-11-06,1976,Sunderland,Liverpool,0-1,0,1,1,1,1,-1,A,"Paisley, Bob",1,Away
1976-11-09,1976,Liverpool,Leicester City,5-1,5,1,1,1,6,4,H,"Paisley, Bob",5,Anfield
1976-11-20,1976,Arsenal,Liverpool,1-1,1,1,1,1,2,0,D,"Paisley, Bob",1,Away
1976-11-27,1976,Liverpool,Bristol City,2-1,2,1,1,1,3,1,H,"Paisley, Bob",2,Anfield
1976-12-04,1976,Ipswich Town,Liverpool,1-0,1,0,1,1,1,1,H,"Paisley, Bob",0,Away
1976-12-11,1976,Liverpool,Queens Park Rangers,3-1,3,1,1,1,4,2,H,"Paisley, Bob",3,Anfield
1976-12-15,1976,Aston Villa,Liverpool,5-1,5,1,1,1,6,4,H,"Paisley, Bob",1,Away
1976-12-18,1976,West Ham United,Liverpool,2-0,2,0,1,1,2,2,H,"Paisley, Bob",0,Away
1976-12-27,1976,Liverpool,Stoke City,4-0,4,0,1,1,4,4,H,"Paisley, Bob",4,Anfield
1976-12-29,1976,Manchester City,Liverpool,1-1,1,1,1,1,2,0,D,"Paisley, Bob",1,Away
1977-01-01,1976,Liverpool,Sunderland,2-0,2,0,1,1,2,2,H,"Paisley, Bob",2,Anfield
1977-01-15,1976,Liverpool,West Bromwich Albion,1-1,1,1,1,1,2,0,D,"Paisley, Bob",1,Anfield
1977-01-22,1976,Norwich City,Liverpool,2-1,2,1,1,1,3,1,H,"Paisley, Bob",1,Away
1977-02-05,1976,Liverpool,Birmingham City,4-1,4,1,1,1,5,3,H,"Paisley, Bob",4,Anfield
1977-02-16,1976,Manchester United,Liverpool,0-0,0,0,1,1,0,0,D,"Paisley, Bob",0,Away
1977-02-19,1976,Liverpool,Derby County,3-1,3,1,1,1,4,2,H,"Paisley, Bob",3,Anfield
1977-03-05,1976,Liverpool,Newcastle United,1-0,1,0,1,1,1,1,H,"Paisley, Bob",1,Anfield
1977-03-09,1976,Tottenham Hotspur,Liverpool,1-0,1,0,1,1,1,1,H,"Paisley, Bob",0,Away
1977-03-12,1976,Middlesbrough,Liverpool,0-1,0,1,1,1,1,-1,A,"Paisley, Bob",1,Away
1977-03-22,1976,Everton,Liverpool,0-0,0,0,1,1,0,0,D,"Paisley, Bob",0,Away
1977-04-02,1976,Liverpool,Leeds United,3-1,3,1,1,1,4,2,H,"Paisley, Bob",3,Anfield
1977-04-09,1976,Liverpool,Manchester City,2-1,2,1,1,1,3,1,H,"Paisley, Bob",2,Anfield
1977-04-11,1976,Stoke City,Liverpool,0-0,0,0,1,1,0,0,D,"Paisley, Bob",0,Away
1977-04-16,1976,Liverpool,Arsenal,2-0,2,0,1,1,2,2,H,"Paisley, Bob",2,Anfield
1977-04-30,1976,Liverpool,Ipswich Town,2-1,2,1,1,1,3,1,H,"Paisley, Bob",2,Anfield
1977-05-03,1976,Liverpool,Manchester United,1-0,1,0,1,1,1,1,H,"Paisley, Bob",1,Anfield
1977-05-07,1976,Queens Park Rangers,Liverpool,1-1,1,1,1,1,2,0,D,"Paisley, Bob",1,Away
1977-05-10,1976,Coventry City,Liverpool,0-0,0,0,1,1,0,0,D,"Paisley, Bob",0,Away
1977-05-14,1976,Liverpool,West Ham United,0-0,0,0,1,1,0,0,D,"Paisley, Bob",0,Anfield
1977-05-16,1976,Bristol City,Liverpool,2-1,2,1,1,1,3,1,H,"Paisley, Bob",1,Away
1977-08-20,1977,Middlesbrough,Liverpool,1-1,1,1,1,1,2,0,D,"Paisley, Bob",1,Away
1977-08-23,1977,Liverpool,Newcastle United,2-0,2,0,1,1,2,2,H,"Paisley, Bob",2,Anfield
1977-08-27,1977,Liverpool,West Bromwich Albion,3-0,3,0,1,1,3,3,H,"Paisley, Bob",3,Anfield
1977-09-03,1977,Birmingham City,Liverpool,0-1,0,1,1,1,1,-1,A,"Paisley, Bob",1,Away
1977-09-10,1977,Liverpool,Coventry City,2-0,2,0,1,1,2,2,H,"Paisley, Bob",2,Anfield
1977-09-17,1977,Ipswich Town,Liverpool,1-1,1,1,1,1,2,0,D,"Paisley, Bob",1,Away
1977-09-24,1977,Liverpool,Derby County,1-0,1,0,1,1,1,1,H,"Paisley, Bob",1,Anfield
1977-10-01,1977,Manchester United,Liverpool,2-0,2,0,1,1,2,2,H,"Paisley, Bob",0,Away
1977-10-04,1977,Arsenal,Liverpool,0-0,0,0,1,1,0,0,D,"Paisley, Bob",0,Away
1977-10-08,1977,Liverpool,Chelsea,2-0,2,0,1,1,2,2,H,"Paisley, Bob",2,Anfield
1977-10-15,1977,Leeds United,Liverpool,1-2,1,2,1,1,3,-1,A,"Paisley, Bob",2,Away
1977-10-22,1977,Liverpool,Everton,0-0,0,0,1,1,0,0,D,"Paisley, Bob",0,Anfield
1977-10-29,1977,Manchester City,Liverpool,3-1,3,1,1,1,4,2,H,"Paisley, Bob",1,Away
1977-11-05,1977,Liverpool,Aston Villa,1-2,1,2,1,1,3,-1,A,"Paisley, Bob",1,Anfield
1977-11-12,1977,Queens Park Rangers,Liverpool,2-0,2,0,1,1,2,2,H,"Paisley, Bob",0,Away
1977-11-19,1977,Liverpool,Bristol City,1-1,1,1,1,1,2,0,D,"Paisley, Bob",1,Anfield
1977-11-26,1977,Leicester City,Liverpool,0-4,0,4,1,1,4,-4,A,"Paisley, Bob",4,Away
1977-12-03,1977,Liverpool,West Ham United,2-0,2,0,1,1,2,2,H,"Paisley, Bob",2,Anfield
1977-12-10,1977,Norwich City,Liverpool,2-1,2,1,1,1,3,1,H,"Paisley, Bob",1,Away
1977-12-17,1977,Liverpool,Queens Park Rangers,1-0,1,0,1,1,1,1,H,"Paisley, Bob",1,Anfield
1977-12-26,1977,Nottingham Forest,Liverpool,1-1,1,1,1,1,2,0,D,"Paisley, Bob",1,Away
1977-12-27,1977,Liverpool,Wolverhampton Wanderers,1-0,1,0,1,1,1,1,H,"Paisley, Bob",1,Anfield
1977-12-31,1977,Newcastle United,Liverpool,0-2,0,2,1,1,2,-2,A,"Paisley, Bob",2,Away
1978-01-02,1977,Liverpool,Middlesbrough,2-0,2,0,1,1,2,2,H,"Paisley, Bob",2,Anfield
1978-01-14,1977,West Bromwich Albion,Liverpool,0-1,0,1,1,1,1,-1,A,"Paisley, Bob",1,Away
1978-01-21,1977,Liverpool,Birmingham City,2-3,2,3,1,1,5,-1,A,"Paisley, Bob",2,Anfield
1978-02-04,1977,Coventry City,Liverpool,1-0,1,0,1,1,1,1,H,"Paisley, Bob",0,Away
1978-02-25,1977,Liverpool,Manchester United,3-1,3,1,1,1,4,2,H,"Paisley, Bob",3,Anfield
1978-03-04,1977,Chelsea,Liverpool,3-1,3,1,1,1,4,2,H,"Paisley, Bob",1,Away
1978-03-08,1977,Derby County,Liverpool,4-2,4,2,1,1,6,2,H,"Paisley, Bob",2,Away
1978-03-11,1977,Liverpool,Leeds United,1-0,1,0,1,1,1,1,H,"Paisley, Bob",1,Anfield
1978-03-25,1977,Wolverhampton Wanderers,Liverpool,1-3,1,3,1,1,4,-2,A,"Paisley, Bob",3,Away
1978-04-01,1977,Aston Villa,Liverpool,0-3,0,3,1,1,3,-3,A,"Paisley, Bob",3,Away
1978-04-05,1977,Everton,Liverpool,0-1,0,1,1,1,1,-1,A,"Paisley, Bob",1,Away
1978-04-08,1977,Liverpool,Leicester City,3-2,3,2,1,1,5,1,H,"Paisley, Bob",3,Anfield
1978-04-15,1977,Bristol City,Liverpool,1-1,1,1,1,1,2,0,D,"Paisley, Bob",1,Away
1978-04-18,1977,Liverpool,Ipswich Town,2-2,2,2,1,1,4,0,D,"Paisley, Bob",2,Anfield
1978-04-22,1977,Liverpool,Norwich City,3-0,3,0,1,1,3,3,H,"Paisley, Bob",3,Anfield
1978-04-25,1977,Liverpool,Arsenal,1-0,1,0,1,1,1,1,H,"Paisley, Bob",1,Anfield
1978-04-29,1977,West Ham United,Liverpool,0-2,0,2,1,1,2,-2,A,"Paisley, Bob",2,Away
1978-05-01,1977,Liverpool,Manchester City,4-0,4,0,1,1,4,4,H,"Paisley, Bob",4,Anfield
1978-05-04,1977,Liverpool,Nottingham Forest,0-0,0,0,1,1,0,0,D,"Paisley, Bob",0,Anfield
1978-08-19,1978,Liverpool,Queens Park Rangers,2-1,2,1,1,1,3,1,H,"Paisley, Bob",2,Anfield
1978-08-22,1978,Ipswich Town,Liverpool,0-3,0,3,1,1,3,-3,A,"Paisley, Bob",3,Away
1978-08-26,1978,Manchester City,Liverpool,1-4,1,4,1,1,5,-3,A,"Paisley, Bob",4,Away
1978-09-02,1978,Liverpool,Tottenham Hotspur,7-0,7,0,1,1,7,7,H,"Paisley, Bob",7,Anfield
1978-09-09,1978,Birmingham City,Liverpool,0-3,0,3,1,1,3,-3,A,"Paisley, Bob",3,Away
1978-09-16,1978,Liverpool,Coventry City,1-0,1,0,1,1,1,1,H,"Paisley, Bob",1,Anfield
1978-09-23,1978,West Bromwich Albion,Liverpool,1-1,1,1,1,1,2,0,D,"Paisley, Bob",1,Away
1978-09-30,1978,Liverpool,Bolton Wanderers,3-0,3,0,1,1,3,3,H,"Paisley, Bob",3,Anfield
1978-10-07,1978,Norwich City,Liverpool,1-4,1,4,1,1,5,-3,A,"Paisley, Bob",4,Away
1978-10-14,1978,Liverpool,Derby County,5-0,5,0,1,1,5,5,H,"Paisley, Bob",5,Anfield
1978-10-21,1978,Liverpool,Chelsea,2-0,2,0,1,1,2,2,H,"Paisley, Bob",2,Anfield
1978-10-28,1978,Everton,Liverpool,1-0,1,0,1,1,1,1,H,"Paisley, Bob",0,Away
1978-11-04,1978,Liverpool,Leeds United,1-1,1,1,1,1,2,0,D,"Paisley, Bob",1,Anfield
1978-11-11,1978,Queens Park Rangers,Liverpool,1-3,1,3,1,1,4,-2,A,"Paisley, Bob",3,Away
1978-11-18,1978,Liverpool,Manchester City,1-0,1,0,1,1,1,1,H,"Paisley, Bob",1,Anfield
1978-11-22,1978,Tottenham Hotspur,Liverpool,0-0,0,0,1,1,0,0,D,"Paisley, Bob",0,Away
1978-11-25,1978,Liverpool,Middlesbrough,2-0,2,0,1,1,2,2,H,"Paisley, Bob",2,Anfield
1978-12-02,1978,Arsenal,Liverpool,1-0,1,0,1,1,1,1,H,"Paisley, Bob",0,Away
1978-12-09,1978,Liverpool,Nottingham Forest,2-0,2,0,1,1,2,2,H,"Paisley, Bob",2,Anfield
1978-12-16,1978,Bristol City,Liverpool,1-0,1,0,1,1,1,1,H,"Paisley, Bob",0,Away
1978-12-26,1978,Manchester United,Liverpool,0-3,0,3,1,1,3,-3,A,"Paisley, Bob",3,Away
1979-02-03,1978,Liverpool,West Bromwich Albion,2-1,2,1,1,1,3,1,H,"Paisley, Bob",2,Anfield
1979-02-13,1978,Liverpool,Birmingham City,1-0,1,0,1,1,1,1,H,"Paisley, Bob",1,Anfield
1979-02-21,1978,Liverpool,Norwich City,6-0,6,0,1,1,6,6,H,"Paisley, Bob",6,Anfield
1979-02-24,1978,Derby County,Liverpool,0-2,0,2,1,1,2,-2,A,"Paisley, Bob",2,Away
1979-03-03,1978,Chelsea,Liverpool,0-0,0,0,1,1,0,0,D,"Paisley, Bob",0,Away
1979-03-06,1978,Coventry City,Liverpool,0-0,0,0,1,1,0,0,D,"Paisley, Bob",0,Away
1979-03-13,1978,Liverpool,Everton,1-1,1,1,1,1,2,0,D,"Paisley, Bob",1,Anfield
1979-03-20,1978,Liverpool,Wolverhampton Wanderers,2-0,2,0,1,1,2,2,H,"Paisley, Bob",2,Anfield
1979-03-24,1978,Liverpool,Ipswich Town,2-0,2,0,1,1,2,2,H,"Paisley, Bob",2,Anfield
1979-04-07,1978,Liverpool,Arsenal,3-0,3,0,1,1,3,3,H,"Paisley, Bob",3,Anfield
1979-04-10,1978,Wolverhampton Wanderers,Liverpool,0-1,0,1,1,1,1,-1,A,"Paisley, Bob",1,Away
1979-04-14,1978,Liverpool,Manchester United,2-0,2,0,1,1,2,2,H,"Paisley, Bob",2,Anfield
1979-04-16,1978,Aston Villa,Liverpool,3-1,3,1,1,1,4,2,H,"Paisley, Bob",1,Away
1979-04-21,1978,Liverpool,Bristol City,1-0,1,0,1,1,1,1,H,"Paisley, Bob",1,Anfield
1979-04-24,1978,Southampton,Liverpool,1-1,1,1,1,1,2,0,D,"Paisley, Bob",1,Away
1979-04-28,1978,Nottingham Forest,Liverpool,0-0,0,0,1,1,0,0,D,"Paisley, Bob",0,Away
1979-05-01,1978,Bolton Wanderers,Liverpool,1-4,1,4,1,1,5,-3,A,"Paisley, Bob",4,Away
1979-05-05,1978,Liverpool,Southampton,2-0,2,0,1,1,2,2,H,"Paisley, Bob",2,Anfield
1979-05-08,1978,Liverpool,Aston Villa,3-0,3,0,1,1,3,3,H,"Paisley, Bob",3,Anfield
1979-05-11,1978,Middlesbrough,Liverpool,0-1,0,1,1,1,1,-1,A,"Paisley, Bob",1,Away
1979-05-17,1978,Leeds United,Liverpool,0-3,0,3,1,1,3,-3,A,"Paisley, Bob",3,Away
1979-08-21,1979,Liverpool,Bolton Wanderers,0-0,0,0,1,1,0,0,D,"Paisley, Bob",0,Anfield
1979-08-25,1979,Liverpool,West Bromwich Albion,3-1,3,1,1,1,4,2,H,"Paisley, Bob",3,Anfield
1979-09-01,1979,Southampton,Liverpool,3-2,3,2,1,1,5,1,H,"Paisley, Bob",2,Away
1979-09-08,1979,Liverpool,Coventry City,4-0,4,0,1,1,4,4,H,"Paisley, Bob",4,Anfield
1979-09-15,1979,Leeds United,Liverpool,1-1,1,1,1,1,2,0,D,"Paisley, Bob",1,Away
1979-09-22,1979,Liverpool,Norwich City,0-0,0,0,1,1,0,0,D,"Paisley, Bob",0,Anfield
1979-09-29,1979,Nottingham Forest,Liverpool,1-0,1,0,1,1,1,1,H,"Paisley, Bob",0,Away
1979-10-06,1979,Liverpool,Bristol City,4-0,4,0,1,1,4,4,H,"Paisley, Bob",4,Anfield
1979-10-09,1979,Bolton Wanderers,Liverpool,1-1,1,1,1,1,2,0,D,"Paisley, Bob",1,Away
1979-10-13,1979,Ipswich Town,Liverpool,1-2,1,2,1,1,3,-1,A,"Paisley, Bob",2,Away
1979-10-20,1979,Liverpool,Everton,2-2,2,2,1,1,4,0,D,"Paisley, Bob",2,Anfield
1979-10-27,1979,Manchester City,Liverpool,0-4,0,4,1,1,4,-4,A,"Paisley, Bob",4,Away
1979-11-03,1979,Liverpool,Wolverhampton Wanderers,3-0,3,0,1,1,3,3,H,"Paisley, Bob",3,Anfield
1979-11-10,1979,Brighton & Hove Albion,Liverpool,1-4,1,4,1,1,5,-3,A,"Paisley, Bob",4,Away
1979-11-17,1979,Liverpool,Tottenham Hotspur,2-1,2,1,1,1,3,1,H,"Paisley, Bob",2,Anfield
1979-11-24,1979,Arsenal,Liverpool,0-0,0,0,1,1,0,0,D,"Paisley, Bob",0,Away
1979-12-01,1979,Liverpool,Middlesbrough,4-0,4,0,1,1,4,4,H,"Paisley, Bob",4,Anfield
1979-12-08,1979,Aston Villa,Liverpool,1-3,1,3,1,1,4,-2,A,"Paisley, Bob",3,Away
1979-12-15,1979,Liverpool,Crystal Palace,3-0,3,0,1,1,3,3,H,"Paisley, Bob",3,Anfield
1979-12-22,1979,Derby County,Liverpool,1-3,1,3,1,1,4,-2,A,"Paisley, Bob",3,Away
1979-12-26,1979,Liverpool,Manchester United,2-0,2,0,1,1,2,2,H,"Paisley, Bob",2,Anfield
1979-12-29,1979,West Bromwich Albion,Liverpool,0-2,0,2,1,1,2,-2,A,"Paisley, Bob",2,Away
1980-01-12,1979,Liverpool,Southampton,1-1,1,1,1,1,2,0,D,"Paisley, Bob",1,Anfield
1980-01-19,1979,Coventry City,Liverpool,1-0,1,0,1,1,1,1,H,"Paisley, Bob",0,Away
1980-02-09,1979,Norwich City,Liverpool,3-5,3,5,1,1,8,-2,A,"Paisley, Bob",5,Away
1980-02-19,1979,Liverpool,Nottingham Forest,2-0,2,0,1,1,2,2,H,"Paisley, Bob",2,Anfield
1980-02-23,1979,Liverpool,Ipswich Town,1-1,1,1,1,1,2,0,D,"Paisley, Bob",1,Anfield
1980-02-26,1979,Wolverhampton Wanderers,Liverpool,1-0,1,0,1,1,1,1,H,"Paisley, Bob",0,Away
1980-03-01,1979,Everton,Liverpool,1-2,1,2,1,1,3,-1,A,"Paisley, Bob",2,Away
1980-03-11,1979,Liverpool,Manchester City,2-0,2,0,1,1,2,2,H,"Paisley, Bob",2,Anfield
1980-03-15,1979,Bristol City,Liverpool,1-3,1,3,1,1,4,-2,A,"Paisley, Bob",3,Away
1980-03-19,1979,Liverpool,Leeds United,3-0,3,0,1,1,3,3,H,"Paisley, Bob",3,Anfield
1980-03-22,1979,Liverpool,Brighton & Hove Albion,1-0,1,0,1,1,1,1,H,"Paisley, Bob",1,Anfield
1980-03-29,1979,Tottenham Hotspur,Liverpool,2-0,2,0,1,1,2,2,H,"Paisley, Bob",0,Away
1980-04-01,1979,Liverpool,Stoke City,1-0,1,0,1,1,1,1,H,"Paisley, Bob",1,Anfield
1980-04-05,1979,Manchester United,Liverpool,2-1,2,1,1,1,3,1,H,"Paisley, Bob",1,Away
1980-04-08,1979,Liverpool,Derby County,3-0,3,0,1,1,3,3,H,"Paisley, Bob",3,Anfield
1980-04-19,1979,Liverpool,Arsenal,1-1,1,1,1,1,2,0,D,"Paisley, Bob",1,Anfield
1980-04-23,1979,Stoke City,Liverpool,0-2,0,2,1,1,2,-2,A,"Paisley, Bob",2,Away
1980-04-26,1979,Crystal Palace,Liverpool,0-0,0,0,1,1,0,0,D,"Paisley, Bob",0,Away
1980-05-03,1979,Liverpool,Aston Villa,4-1,4,1,1,1,5,3,H,"Paisley, Bob",4,Anfield
1980-05-06,1979,Middlesbrough,Liverpool,1-0,1,0,1,1,1,1,H,"Paisley, Bob",0,Away
1980-08-16,1980,Liverpool,Crystal Palace,3-0,3,0,1,1,3,3,H,"Paisley, Bob",3,Anfield
1980-08-19,1980,Coventry City,Liverpool,0-0,0,0,1,1,0,0,D,"Paisley, Bob",0,Away
1980-08-23,1980,Leicester City,Liverpool,2-0,2,0,1,1,2,2,H,"Paisley, Bob",0,Away
1980-08-30,1980,Liverpool,Norwich City,4-1,4,1,1,1,5,3,H,"Paisley, Bob",4,Anfield
1980-09-06,1980,Birmingham City,Liverpool,1-1,1,1,1,1,2,0,D,"Paisley, Bob",1,Away
1980-09-13,1980,Liverpool,West Bromwich Albion,4-0,4,0,1,1,4,4,H,"Paisley, Bob",4,Anfield
1980-09-20,1980,Southampton,Liverpool,2-2,2,2,1,1,4,0,D,"Paisley, Bob",2,Away
1980-09-27,1980,Liverpool,Brighton & Hove Albion,4-1,4,1,1,1,5,3,H,"Paisley, Bob",4,Anfield
1980-10-04,1980,Manchester City,Liverpool,0-3,0,3,1,1,3,-3,A,"Paisley, Bob",3,Away
1980-10-07,1980,Liverpool,Middlesbrough,4-2,4,2,1,1,6,2,H,"Paisley, Bob",4,Anfield
1980-10-11,1980,Liverpool,Ipswich Town,1-1,1,1,1,1,2,0,D,"Paisley, Bob",1,Anfield
1980-10-18,1980,Everton,Liverpool,2-2,2,2,1,1,4,0,D,"Paisley, Bob",2,Away
1980-10-25,1980,Liverpool,Arsenal,1-1,1,1,1,1,2,0,D,"Paisley, Bob",1,Anfield
1980-11-01,1980,Stoke City,Liverpool,2-2,2,2,1,1,4,0,D,"Paisley, Bob",2,Away
1980-11-08,1980,Liverpool,Nottingham Forest,0-0,0,0,1,1,0,0,D,"Paisley, Bob",0,Anfield
1980-11-11,1980,Liverpool,Coventry City,2-1,2,1,1,1,3,1,H,"Paisley, Bob",2,Anfield
1980-11-15,1980,Crystal Palace,Liverpool,2-2,2,2,1,1,4,0,D,"Paisley, Bob",2,Away
1980-11-22,1980,Liverpool,Aston Villa,2-1,2,1,1,1,3,1,H,"Paisley, Bob",2,Anfield
1980-11-25,1980,Wolverhampton Wanderers,Liverpool,4-1,4,1,1,1,5,3,H,"Paisley, Bob",1,Away
1980-11-29,1980,Sunderland,Liverpool,2-4,2,4,1,1,6,-2,A,"Paisley, Bob",4,Away
1980-12-06,1980,Liverpool,Tottenham Hotspur,2-1,2,1,1,1,3,1,H,"Paisley, Bob",2,Anfield
1980-12-13,1980,Ipswich Town,Liverpool,1-1,1,1,1,1,2,0,D,"Paisley, Bob",1,Away
1980-12-20,1980,Liverpool,Wolverhampton Wanderers,1-0,1,0,1,1,1,1,H,"Paisley, Bob",1,Anfield
1980-12-26,1980,Manchester United,Liverpool,0-0,0,0,1,1,0,0,D,"Paisley, Bob",0,Away
1980-12-27,1980,Liverpool,Leeds United,0-0,0,0,1,1,0,0,D,"Paisley, Bob",0,Anfield
1981-01-10,1980,Aston Villa,Liverpool,2-0,2,0,1,1,2,2,H,"Paisley, Bob",0,Away
1981-01-17,1980,Norwich City,Liverpool,0-1,0,1,1,1,1,-1,A,"Paisley, Bob",1,Away
1981-01-31,1980,Liverpool,Leicester City,1-2,1,2,1,1,3,-1,A,"Paisley, Bob",1,Anfield
1981-02-07,1980,West Bromwich Albion,Liverpool,2-0,2,0,1,1,2,2,H,"Paisley, Bob",0,Away
1981-02-14,1980,Liverpool,Birmingham City,2-2,2,2,1,1,4,0,D,"Paisley, Bob",2,Anfield
1981-02-21,1980,Brighton & Hove Albion,Liverpool,2-2,2,2,1,1,4,0,D,"Paisley, Bob",2,Away
1981-02-28,1980,Liverpool,Southampton,2-0,2,0,1,1,2,2,H,"Paisley, Bob",2,Anfield
1981-03-21,1980,Liverpool,Everton,1-0,1,0,1,1,1,1,H,"Paisley, Bob",1,Anfield
1981-03-28,1980,Arsenal,Liverpool,1-0,1,0,1,1,1,1,H,"Paisley, Bob",0,Away
1981-04-03,1980,Liverpool,Stoke City,3-0,3,0,1,1,3,3,H,"Paisley, Bob",3,Anfield
1981-04-11,1980,Nottingham Forest,Liverpool,0-0,0,0,1,1,0,0,D,"Paisley, Bob",0,Away
1981-04-14,1980,Liverpool,Manchester United,0-1,0,1,1,1,1,-1,A,"Paisley, Bob",0,Anfield
1981-04-18,1980,Leeds United,Liverpool,0-0,0,0,1,1,0,0,D,"Paisley, Bob",0,Away
1981-04-25,1980,Tottenham Hotspur,Liverpool,1-1,1,1,1,1,2,0,D,"Paisley, Bob",1,Away
1981-05-02,1980,Liverpool,Sunderland,0-1,0,1,1,1,1,-1,A,"Paisley, Bob",0,Anfield
1981-05-05,1980,Middlesbrough,Liverpool,1-2,1,2,1,1,3,-1,A,"Paisley, Bob",2,Away
1981-05-19,1980,Liverpool,Manchester City,1-0,1,0,1,1,1,1,H,"Paisley, Bob",1,Anfield
1981-08-29,1981,Wolverhampton Wanderers,Liverpool,1-0,1,0,1,1,1,1,H,"Paisley, Bob",0,Away
1981-09-01,1981,Liverpool,Middlesbrough,1-1,1,1,1,1,2,0,D,"Paisley, Bob",1,Anfield
1981-09-05,1981,Liverpool,Arsenal,2-0,2,0,1,1,2,2,H,"Paisley, Bob",2,Anfield
1981-09-12,1981,Ipswich Town,Liverpool,2-0,2,0,1,1,2,2,H,"Paisley, Bob",0,Away
1981-09-19,1981,Liverpool,Aston Villa,0-0,0,0,1,1,0,0,D,"Paisley, Bob",0,Anfield
1981-09-22,1981,Coventry City,Liverpool,1-2,1,2,1,1,3,-1,A,"Paisley, Bob",2,Away
1981-09-26,1981,West Ham United,Liverpool,1-1,1,1,1,1,2,0,D,"Paisley, Bob",1,Away
1981-10-03,1981,Liverpool,Swansea City,2-2,2,2,1,1,4,0,D,"Paisley, Bob",2,Anfield
1981-10-10,1981,Liverpool,Leeds United,3-0,3,0,1,1,3,3,H,"Paisley, Bob",3,Anfield
1981-10-17,1981,Brighton & Hove Albion,Liverpool,3-3,3,3,1,1,6,0,D,"Paisley, Bob",3,Away
1981-10-24,1981,Liverpool,Manchester United,1-2,1,2,1,1,3,-1,A,"Paisley, Bob",1,Anfield
1981-10-31,1981,Sunderland,Liverpool,0-2,0,2,1,1,2,-2,A,"Paisley, Bob",2,Away
1981-11-07,1981,Liverpool,Everton,3-1,3,1,1,1,4,2,H,"Paisley, Bob",3,Anfield
1981-11-21,1981,West Bromwich Albion,Liverpool,1-1,1,1,1,1,2,0,D,"Paisley, Bob",1,Away
1981-11-28,1981,Liverpool,Southampton,0-1,0,1,1,1,1,-1,A,"Paisley, Bob",0,Anfield
1981-12-05,1981,Nottingham Forest,Liverpool,0-2,0,2,1,1,2,-2,A,"Paisley, Bob",2,Away
1981-12-26,1981,Liverpool,Manchester City,1-3,1,3,1,1,4,-2,A,"Paisley, Bob",1,Anfield
1982-01-05,1981,Liverpool,West Ham United,3-0,3,0,1,1,3,3,H,"Paisley, Bob",3,Anfield
1982-01-16,1981,Liverpool,Wolverhampton Wanderers,2-1,2,1,1,1,3,1,H,"Paisley, Bob",2,Anfield
1982-01-26,1981,Notts County,Liverpool,0-4,0,4,1,1,4,-4,A,"Paisley, Bob",4,Away
1982-01-30,1981,Aston Villa,Liverpool,0-3,0,3,1,1,3,-3,A,"Paisley, Bob",3,Away
1982-02-06,1981,Liverpool,Ipswich Town,4-0,4,0,1,1,4,4,H,"Paisley, Bob",4,Anfield
1982-02-16,1981,Swansea City,Liverpool,2-0,2,0,1,1,2,2,H,"Paisley, Bob",0,Away
1982-02-20,1981,Liverpool,Coventry City,4-0,4,0,1,1,4,4,H,"Paisley, Bob",4,Anfield
1982-02-27,1981,Leeds United,Liverpool,0-2,0,2,1,1,2,-2,A,"Paisley, Bob",2,Away
1982-03-06,1981,Liverpool,Brighton & Hove Albion,0-1,0,1,1,1,1,-1,A,"Paisley, Bob",0,Anfield
1982-03-09,1981,Stoke City,Liverpool,1-5,1,5,1,1,6,-4,A,"Paisley, Bob",5,Away
1982-03-20,1981,Liverpool,Sunderland,1-0,1,0,1,1,1,1,H,"Paisley, Bob",1,Anfield
1982-03-27,1981,Everton,Liverpool,1-3,1,3,1,1,4,-2,A,"Paisley, Bob",3,Away
1982-03-30,1981,Liverpool,Birmingham City,3-1,3,1,1,1,4,2,H,"Paisley, Bob",3,Anfield
1982-04-02,1981,Liverpool,Notts County,1-0,1,0,1,1,1,1,H,"Paisley, Bob",1,Anfield
1982-04-07,1981,Manchester United,Liverpool,0-1,0,1,1,1,1,-1,A,"Paisley, Bob",1,Away
1982-04-10,1981,Manchester City,Liverpool,0-5,0,5,1,1,5,-5,A,"Paisley, Bob",5,Away
1982-04-13,1981,Liverpool,Stoke City,2-0,2,0,1,1,2,2,H,"Paisley, Bob",2,Anfield
1982-04-17,1981,Liverpool,West Bromwich Albion,1-0,1,0,1,1,1,1,H,"Paisley, Bob",1,Anfield
1982-04-24,1981,Southampton,Liverpool,2-3,2,3,1,1,5,-1,A,"Paisley, Bob",3,Away
1982-05-01,1981,Liverpool,Nottingham Forest,2-0,2,0,1,1,2,2,H,"Paisley, Bob",2,Anfield
1982-05-03,1981,Tottenham Hotspur,Liverpool,2-2,2,2,1,1,4,0,D,"Paisley, Bob",2,Away
1982-05-08,1981,Birmingham City,Liverpool,0-1,0,1,1,1,1,-1,A,"Paisley, Bob",1,Away
1982-05-11,1981,Arsenal,Liverpool,1-1,1,1,1,1,2,0,D,"Paisley, Bob",1,Away
1982-05-15,1981,Liverpool,Tottenham Hotspur,3-1,3,1,1,1,4,2,H,"Paisley, Bob",3,Anfield
1982-05-18,1981,Middlesbrough,Liverpool,0-0,0,0,1,1,0,0,D,"Paisley, Bob",0,Away
1982-08-28,1982,Liverpool,West Bromwich Albion,2-0,2,0,1,1,2,2,H,"Paisley, Bob",2,Anfield
1982-08-31,1982,Birmingham City,Liverpool,0-0,0,0,1,1,0,0,D,"Paisley, Bob",0,Away
1982-09-04,1982,Arsenal,Liverpool,0-2,0,2,1,1,2,-2,A,"Paisley, Bob",2,Away
1982-09-07,1982,Liverpool,Nottingham Forest,4-3,4,3,1,1,7,1,H,"Paisley, Bob",4,Anfield
1982-09-11,1982,Liverpool,Luton Town,3-3,3,3,1,1,6,0,D,"Paisley, Bob",3,Anfield
1982-09-18,1982,Swansea City,Liverpool,0-3,0,3,1,1,3,-3,A,"Paisley, Bob",3,Away
1982-09-25,1982,Liverpool,Southampton,5-0,5,0,1,1,5,5,H,"Paisley, Bob",5,Anfield
1982-10-02,1982,Ipswich Town,Liverpool,1-0,1,0,1,1,1,1,H,"Paisley, Bob",0,Away
1982-10-09,1982,West Ham United,Liverpool,3-1,3,1,1,1,4,2,H,"Paisley, Bob",1,Away
1982-10-16,1982,Liverpool,Manchester United,0-0,0,0,1,1,0,0,D,"Paisley, Bob",0,Anfield
1982-10-23,1982,Stoke City,Liverpool,1-1,1,1,1,1,2,0,D,"Paisley, Bob",1,Away
1982-10-30,1982,Liverpool,Brighton & Hove Albion,3-1,3,1,1,1,4,2,H,"Paisley, Bob",3,Anfield
1982-11-06,1982,Everton,Liverpool,0-5,0,5,1,1,5,-5,A,"Paisley, Bob",5,Away
1982-11-13,1982,Liverpool,Coventry City,4-0,4,0,1,1,4,4,H,"Paisley, Bob",4,Anfield
1982-11-20,1982,Notts County,Liverpool,1-2,1,2,1,1,3,-1,A,"Paisley, Bob",2,Away
1982-11-27,1982,Liverpool,Tottenham Hotspur,3-0,3,0,1,1,3,3,H,"Paisley, Bob",3,Anfield
1982-12-04,1982,Norwich City,Liverpool,1-0,1,0,1,1,1,1,H,"Paisley, Bob",0,Away
1982-12-11,1982,Liverpool,Watford,3-1,3,1,1,1,4,2,H,"Paisley, Bob",3,Anfield
1982-12-18,1982,Aston Villa,Liverpool,2-4,2,4,1,1,6,-2,A,"Paisley, Bob",4,Away
1982-12-27,1982,Liverpool,Manchester City,5-2,5,2,1,1,7,3,H,"Paisley, Bob",5,Anfield
1982-12-28,1982,Sunderland,Liverpool,0-0,0,0,1,1,0,0,D,"Paisley, Bob",0,Away
1983-01-01,1982,Liverpool,Notts County,5-1,5,1,1,1,6,4,H,"Paisley, Bob",5,Anfield
1983-01-03,1982,Liverpool,Arsenal,3-1,3,1,1,1,4,2,H,"Paisley, Bob",3,Anfield
1983-01-15,1982,West Bromwich Albion,Liverpool,0-1,0,1,1,1,1,-1,A,"Paisley, Bob",1,Away
1983-01-22,1982,Liverpool,Birmingham City,1-0,1,0,1,1,1,1,H,"Paisley, Bob",1,Anfield
1983-02-05,1982,Luton Town,Liverpool,1-3,1,3,1,1,4,-2,A,"Paisley, Bob",3,Away
1983-02-12,1982,Liverpool,Ipswich Town,1-0,1,0,1,1,1,1,H,"Paisley, Bob",1,Anfield
1983-02-26,1982,Manchester United,Liverpool,1-1,1,1,1,1,2,0,D,"Paisley, Bob",1,Away
1983-03-05,1982,Liverpool,Stoke City,5-1,5,1,1,1,6,4,H,"Paisley, Bob",5,Anfield
1983-03-12,1982,Liverpool,West Ham United,3-0,3,0,1,1,3,3,H,"Paisley, Bob",3,Anfield
1983-03-19,1982,Liverpool,Everton,0-0,0,0,1,1,0,0,D,"Paisley, Bob",0,Anfield
1983-03-22,1982,Brighton & Hove Albion,Liverpool,2-2,2,2,1,1,4,0,D,"Paisley, Bob",2,Away
1983-04-02,1982,Liverpool,Sunderland,1-0,1,0,1,1,1,1,H,"Paisley, Bob",1,Anfield
1983-04-04,1982,Manchester City,Liverpool,0-4,0,4,1,1,4,-4,A,"Paisley, Bob",4,Away
1983-04-09,1982,Liverpool,Swansea City,3-0,3,0,1,1,3,3,H,"Paisley, Bob",3,Anfield
1983-04-12,1982,Coventry City,Liverpool,0-0,0,0,1,1,0,0,D,"Paisley, Bob",0,Away
1983-04-16,1982,Southampton,Liverpool,3-2,3,2,1,1,5,1,H,"Paisley, Bob",2,Away
1983-04-23,1982,Liverpool,Norwich City,0-2,0,2,1,1,2,-2,A,"Paisley, Bob",0,Anfield
1983-04-30,1982,Tottenham Hotspur,Liverpool,2-0,2,0,1,1,2,2,H,"Paisley, Bob",0,Away
1983-05-02,1982,Nottingham Forest,Liverpool,1-0,1,0,1,1,1,1,H,"Paisley, Bob",0,Away
1983-05-07,1982,Liverpool,Aston Villa,1-1,1,1,1,1,2,0,D,"Paisley, Bob",1,Anfield
1983-05-14,1982,Watford,Liverpool,2-1,2,1,1,1,3,1,H,"Paisley, Bob",1,Away
1983-08-27,1983,Wolverhampton Wanderers,Liverpool,1-1,1,1,1,1,2,0,D,"Fagan, Joe",1,Away
1983-08-31,1983,Norwich City,Liverpool,0-1,0,1,1,1,1,-1,A,"Fagan, Joe",1,Away
1983-09-03,1983,Liverpool,Nottingham Forest,1-0,1,0,1,1,1,1,H,"Fagan, Joe",1,Anfield
1983-09-06,1983,Liverpool,Southampton,1-1,1,1,1,1,2,0,D,"Fagan, Joe",1,Anfield
1983-09-10,1983,Arsenal,Liverpool,0-2,0,2,1,1,2,-2,A,"Fagan, Joe",2,Away
1983-09-17,1983,Liverpool,Aston Villa,2-1,2,1,1,1,3,1,H,"Fagan, Joe",2,Anfield
1983-09-24,1983,Manchester United,Liverpool,1-0,1,0,1,1,1,1,H,"Fagan, Joe",0,Away
1983-10-01,1983,Liverpool,Sunderland,0-1,0,1,1,1,1,-1,A,"Fagan, Joe",0,Anfield
1983-10-15,1983,West Ham United,Liverpool,1-3,1,3,1,1,4,-2,A,"Fagan, Joe",3,Away
1983-10-22,1983,Queens Park Rangers,Liverpool,0-1,0,1,1,1,1,-1,A,"Fagan, Joe",1,Away
1983-10-29,1983,Liverpool,Luton Town,6-0,6,0,1,1,6,6,H,"Fagan, Joe",6,Anfield
1983-11-06,1983,Liverpool,Everton,3-0,3,0,1,1,3,3,H,"Fagan, Joe",3,Anfield
1983-11-12,1983,Tottenham Hotspur,Liverpool,2-2,2,2,1,1,4,0,D,"Fagan, Joe",2,Away
1983-11-19,1983,Liverpool,Stoke City,1-0,1,0,1,1,1,1,H,"Fagan, Joe",1,Anfield
1983-11-26,1983,Ipswich Town,Liverpool,1-1,1,1,1,1,2,0,D,"Fagan, Joe",1,Away
1983-12-03,1983,Liverpool,Birmingham City,1-0,1,0,1,1,1,1,H,"Fagan, Joe",1,Anfield
1983-12-10,1983,Coventry City,Liverpool,4-0,4,0,1,1,4,4,H,"Fagan, Joe",0,Away
1983-12-17,1983,Liverpool,Notts County,5-0,5,0,1,1,5,5,H,"Fagan, Joe",5,Anfield
1983-12-26,1983,West Bromwich Albion,Liverpool,1-2,1,2,1,1,3,-1,A,"Fagan, Joe",2,Away
1983-12-27,1983,Liverpool,Leicester City,2-2,2,2,1,1,4,0,D,"Fagan, Joe",2,Anfield
1983-12-31,1983,Nottingham Forest,Liverpool,0-1,0,1,1,1,1,-1,A,"Fagan, Joe",1,Away
1984-01-02,1983,Liverpool,Manchester United,1-1,1,1,1,1,2,0,D,"Fagan, Joe",1,Anfield
1984-01-14,1983,Liverpool,Wolverhampton Wanderers,0-1,0,1,1,1,1,-1,A,"Fagan, Joe",0,Anfield
1984-01-20,1983,Aston Villa,Liverpool,1-3,1,3,1,1,4,-2,A,"Fagan, Joe",3,Away
1984-02-01,1983,Liverpool,Watford,3-0,3,0,1,1,3,3,H,"Fagan, Joe",3,Anfield
1984-02-04,1983,Sunderland,Liverpool,0-0,0,0,1,1,0,0,D,"Fagan, Joe",0,Away
1984-02-11,1983,Liverpool,Arsenal,2-1,2,1,1,1,3,1,H,"Fagan, Joe",2,Anfield
1984-02-18,1983,Luton Town,Liverpool,0-0,0,0,1,1,0,0,D,"Fagan, Joe",0,Away
1984-02-25,1983,Liverpool,Queens Park Rangers,2-0,2,0,1,1,2,2,H,"Fagan, Joe",2,Anfield
1984-03-03,1983,Everton,Liverpool,1-1,1,1,1,1,2,0,D,"Fagan, Joe",1,Away
1984-03-10,1983,Liverpool,Tottenham Hotspur,3-1,3,1,1,1,4,2,H,"Fagan, Joe",3,Anfield
1984-03-16,1983,Southampton,Liverpool,2-0,2,0,1,1,2,2,H,"Fagan, Joe",0,Away
1984-03-31,1983,Watford,Liverpool,0-2,0,2,1,1,2,-2,A,"Fagan, Joe",2,Away
1984-04-07,1983,Liverpool,West Ham United,6-0,6,0,1,1,6,6,H,"Fagan, Joe",6,Anfield
1984-04-14,1983,Stoke City,Liverpool,2-0,2,0,1,1,2,2,H,"Fagan, Joe",0,Away
1984-04-18,1983,Leicester City,Liverpool,3-3,3,3,1,1,6,0,D,"Fagan, Joe",3,Away
1984-04-21,1983,Liverpool,West Bromwich Albion,3-0,3,0,1,1,3,3,H,"Fagan, Joe",3,Anfield
1984-04-28,1983,Liverpool,Ipswich Town,2-2,2,2,1,1,4,0,D,"Fagan, Joe",2,Anfield
1984-05-05,1983,Birmingham City,Liverpool,0-0,0,0,1,1,0,0,D,"Fagan, Joe",0,Away
1984-05-07,1983,Liverpool,Coventry City,5-0,5,0,1,1,5,5,H,"Fagan, Joe",5,Anfield
1984-05-12,1983,Notts County,Liverpool,0-0,0,0,1,1,0,0,D,"Fagan, Joe",0,Away
1984-05-15,1983,Liverpool,Norwich City,1-1,1,1,1,1,2,0,D,"Fagan, Joe",1,Anfield
1984-08-25,1984,Norwich City,Liverpool,3-3,3,3,1,1,6,0,D,"Fagan, Joe",3,Away
1984-08-27,1984,Liverpool,West Ham United,3-0,3,0,1,1,3,3,H,"Fagan, Joe",3,Anfield
1984-09-01,1984,Liverpool,Queens Park Rangers,1-1,1,1,1,1,2,0,D,"Fagan, Joe",1,Anfield
1984-09-04,1984,Luton Town,Liverpool,1-2,1,2,1,1,3,-1,A,"Fagan, Joe",2,Away
1984-09-08,1984,Arsenal,Liverpool,3-1,3,1,1,1,4,2,H,"Fagan, Joe",1,Away
1984-09-15,1984,Liverpool,Sunderland,1-1,1,1,1,1,2,0,D,"Fagan, Joe",1,Anfield
1984-09-22,1984,Manchester United,Liverpool,1-1,1,1,1,1,2,0,D,"Fagan, Joe",1,Away
1984-09-29,1984,Liverpool,Sheffield Wednesday,0-2,0,2,1,1,2,-2,A,"Fagan, Joe",0,Anfield
1984-10-06,1984,Liverpool,West Bromwich Albion,0-0,0,0,1,1,0,0,D,"Fagan, Joe",0,Anfield
1984-10-12,1984,Tottenham Hotspur,Liverpool,1-0,1,0,1,1,1,1,H,"Fagan, Joe",0,Away
1984-10-20,1984,Liverpool,Everton,0-1,0,1,1,1,1,-1,A,"Fagan, Joe",0,Anfield
1984-10-28,1984,Nottingham Forest,Liverpool,0-2,0,2,1,1,2,-2,A,"Fagan, Joe",2,Away
1984-11-03,1984,Stoke City,Liverpool,0-1,0,1,1,1,1,-1,A,"Fagan, Joe",1,Away
1984-11-10,1984,Liverpool,Southampton,1-1,1,1,1,1,2,0,D,"Fagan, Joe",1,Anfield
1984-11-18,1984,Newcastle United,Liverpool,0-2,0,2,1,1,2,-2,A,"Fagan, Joe",2,Away
1984-11-24,1984,Liverpool,Ipswich Town,2-0,2,0,1,1,2,2,H,"Fagan, Joe",2,Anfield
1984-12-01,1984,Chelsea,Liverpool,3-1,3,1,1,1,4,2,H,"Fagan, Joe",1,Away
1984-12-04,1984,Liverpool,Coventry City,3-1,3,1,1,1,4,2,H,"Fagan, Joe",3,Anfield
1984-12-15,1984,Aston Villa,Liverpool,0-0,0,0,1,1,0,0,D,"Fagan, Joe",0,Away
1984-12-21,1984,Queens Park Rangers,Liverpool,0-2,0,2,1,1,2,-2,A,"Fagan, Joe",2,Away
1984-12-26,1984,Liverpool,Leicester City,1-2,1,2,1,1,3,-1,A,"Fagan, Joe",1,Anfield
1984-12-29,1984,Liverpool,Luton Town,1-0,1,0,1,1,1,1,H,"Fagan, Joe",1,Anfield
1985-01-01,1984,Watford,Liverpool,1-1,1,1,1,1,2,0,D,"Fagan, Joe",1,Away
1985-01-19,1984,Liverpool,Norwich City,4-0,4,0,1,1,4,4,H,"Fagan, Joe",4,Anfield
1985-02-02,1984,Sheffield Wednesday,Liverpool,1-1,1,1,1,1,2,0,D,"Fagan, Joe",1,Away
1985-02-12,1984,Liverpool,Arsenal,3-0,3,0,1,1,3,3,H,"Fagan, Joe",3,Anfield
1985-02-23,1984,Liverpool,Stoke City,2-0,2,0,1,1,2,2,H,"Fagan, Joe",2,Anfield
1985-03-02,1984,Liverpool,Nottingham Forest,1-0,1,0,1,1,1,1,H,"Fagan, Joe",1,Anfield
1985-03-16,1984,Liverpool,Tottenham Hotspur,0-1,0,1,1,1,1,-1,A,"Fagan, Joe",0,Anfield
1985-03-23,1984,West Bromwich Albion,Liverpool,0-5,0,5,1,1,5,-5,A,"Fagan, Joe",5,Away
1985-03-31,1984,Liverpool,Manchester United,0-1,0,1,1,1,1,-1,A,"Fagan, Joe",0,Anfield
1985-04-03,1984,Sunderland,Liverpool,0-3,0,3,1,1,3,-3,A,"Fagan, Joe",3,Away
1985-04-06,1984,Leicester City,Liverpool,0-1,0,1,1,1,1,-1,A,"Fagan, Joe",1,Away
1985-04-20,1984,Liverpool,Newcastle United,3-1,3,1,1,1,4,2,H,"Fagan, Joe",3,Anfield
1985-04-27,1984,Ipswich Town,Liverpool,0-0,0,0,1,1,0,0,D,"Fagan, Joe",0,Away
1985-05-04,1984,Liverpool,Chelsea,4-3,4,3,1,1,7,1,H,"Fagan, Joe",4,Anfield
1985-05-06,1984,Coventry City,Liverpool,0-2,0,2,1,1,2,-2,A,"Fagan, Joe",2,Away
1985-05-11,1984,Liverpool,Aston Villa,2-1,2,1,1,1,3,1,H,"Fagan, Joe",2,Anfield
1985-05-14,1984,Southampton,Liverpool,1-1,1,1,1,1,2,0,D,"Fagan, Joe",1,Away
1985-05-17,1984,Liverpool,Watford,4-3,4,3,1,1,7,1,H,"Fagan, Joe",4,Anfield
1985-05-20,1984,West Ham United,Liverpool,0-3,0,3,1,1,3,-3,A,"Fagan, Joe",3,Away
1985-05-23,1984,Everton,Liverpool,1-0,1,0,1,1,1,1,H,"Fagan, Joe",0,Away
1985-08-17,1985,Liverpool,Arsenal,2-0,2,0,1,1,2,2,H,"Dalglish, Kenny",2,Anfield
1985-08-21,1985,Aston Villa,Liverpool,2-2,2,2,1,1,4,0,D,"Dalglish, Kenny",2,Away
1985-08-24,1985,Newcastle United,Liverpool,1-0,1,0,1,1,1,1,H,"Dalglish, Kenny",0,Away
1985-08-26,1985,Liverpool,Ipswich Town,5-0,5,0,1,1,5,5,H,"Dalglish, Kenny",5,Anfield
1985-08-31,1985,West Ham United,Liverpool,2-2,2,2,1,1,4,0,D,"Dalglish, Kenny",2,Away
1985-09-03,1985,Liverpool,Nottingham Forest,2-0,2,0,1,1,2,2,H,"Dalglish, Kenny",2,Anfield
1985-09-07,1985,Liverpool,Watford,3-1,3,1,1,1,4,2,H,"Dalglish, Kenny",3,Anfield
1985-09-14,1985,Oxford United,Liverpool,2-2,2,2,1,1,4,0,D,"Dalglish, Kenny",2,Away
1985-09-21,1985,Everton,Liverpool,2-3,2,3,1,1,5,-1,A,"Dalglish, Kenny",3,Away
1985-09-28,1985,Liverpool,Tottenham Hotspur,4-1,4,1,1,1,5,3,H,"Dalglish, Kenny",4,Anfield
1985-10-05,1985,Queens Park Rangers,Liverpool,2-1,2,1,1,1,3,1,H,"Dalglish, Kenny",1,Away
1985-10-12,1985,Liverpool,Southampton,1-0,1,0,1,1,1,1,H,"Dalglish, Kenny",1,Anfield
1985-10-19,1985,Manchester United,Liverpool,1-1,1,1,1,1,2,0,D,"Dalglish, Kenny",1,Away
1985-10-26,1985,Liverpool,Luton Town,3-2,3,2,1,1,5,1,H,"Dalglish, Kenny",3,Anfield
1985-11-02,1985,Liverpool,Leicester City,1-0,1,0,1,1,1,1,H,"Dalglish, Kenny",1,Anfield
1985-11-09,1985,Coventry City,Liverpool,0-3,0,3,1,1,3,-3,A,"Dalglish, Kenny",3,Away
1985-11-16,1985,Liverpool,West Bromwich Albion,4-1,4,1,1,1,5,3,H,"Dalglish, Kenny",4,Anfield
1985-11-23,1985,Birmingham City,Liverpool,0-2,0,2,1,1,2,-2,A,"Dalglish, Kenny",2,Away
1985-11-30,1985,Liverpool,Chelsea,1-1,1,1,1,1,2,0,D,"Dalglish, Kenny",1,Anfield
1985-12-07,1985,Liverpool,Aston Villa,3-0,3,0,1,1,3,3,H,"Dalglish, Kenny",3,Anfield
1985-12-14,1985,Arsenal,Liverpool,2-0,2,0,1,1,2,2,H,"Dalglish, Kenny",0,Away
1985-12-21,1985,Liverpool,Newcastle United,1-1,1,1,1,1,2,0,D,"Dalglish, Kenny",1,Anfield
1985-12-26,1985,Manchester City,Liverpool,1-0,1,0,1,1,1,1,H,"Dalglish, Kenny",0,Away
1985-12-28,1985,Nottingham Forest,Liverpool,1-1,1,1,1,1,2,0,D,"Dalglish, Kenny",1,Away
1986-01-01,1985,Liverpool,Sheffield Wednesday,2-2,2,2,1,1,4,0,D,"Dalglish, Kenny",2,Anfield
1986-01-12,1985,Watford,Liverpool,2-3,2,3,1,1,5,-1,A,"Dalglish, Kenny",3,Away
1986-01-18,1985,Liverpool,West Ham United,3-1,3,1,1,1,4,2,H,"Dalglish, Kenny",3,Anfield
1986-02-01,1985,Ipswich Town,Liverpool,2-1,2,1,1,1,3,1,H,"Dalglish, Kenny",1,Away
1986-02-09,1985,Liverpool,Manchester United,1-1,1,1,1,1,2,0,D,"Dalglish, Kenny",1,Anfield
1986-02-22,1985,Liverpool,Everton,0-2,0,2,1,1,2,-2,A,"Dalglish, Kenny",0,Anfield
1986-03-02,1985,Tottenham Hotspur,Liverpool,1-2,1,2,1,1,3,-1,A,"Dalglish, Kenny",2,Away
1986-03-08,1985,Liverpool,Queens Park Rangers,4-1,4,1,1,1,5,3,H,"Dalglish, Kenny",4,Anfield
1986-03-15,1985,Southampton,Liverpool,1-2,1,2,1,1,3,-1,A,"Dalglish, Kenny",2,Away
1986-03-22,1985,Liverpool,Oxford United,6-0,6,0,1,1,6,6,H,"Dalglish, Kenny",6,Anfield
1986-03-29,1985,Sheffield Wednesday,Liverpool,0-0,0,0,1,1,0,0,D,"Dalglish, Kenny",0,Away
1986-03-31,1985,Liverpool,Manchester City,2-0,2,0,1,1,2,2,H,"Dalglish, Kenny",2,Anfield
1986-04-12,1985,Liverpool,Coventry City,5-0,5,0,1,1,5,5,H,"Dalglish, Kenny",5,Anfield
1986-04-16,1985,Luton Town,Liverpool,0-1,0,1,1,1,1,-1,A,"Dalglish, Kenny",1,Away
1986-04-19,1985,West Bromwich Albion,Liverpool,1-2,1,2,1,1,3,-1,A,"Dalglish, Kenny",2,Away
1986-04-26,1985,Liverpool,Birmingham City,5-0,5,0,1,1,5,5,H,"Dalglish, Kenny",5,Anfield
1986-04-30,1985,Leicester City,Liverpool,0-2,0,2,1,1,2,-2,A,"Dalglish, Kenny",2,Away
1986-05-03,1985,Chelsea,Liverpool,0-1,0,1,1,1,1,-1,A,"Dalglish, Kenny",1,Away
1986-08-23,1986,Newcastle United,Liverpool,0-2,0,2,1,1,2,-2,A,"Dalglish, Kenny",2,Away
1986-08-25,1986,Liverpool,Manchester City,0-0,0,0,1,1,0,0,D,"Dalglish, Kenny",0,Anfield
1986-08-30,1986,Liverpool,Arsenal,2-1,2,1,1,1,3,1,H,"Dalglish, Kenny",2,Anfield
1986-09-03,1986,Leicester City,Liverpool,2-1,2,1,1,1,3,1,H,"Dalglish, Kenny",1,Away
1986-09-06,1986,West Ham United,Liverpool,2-5,2,5,1,1,7,-3,A,"Dalglish, Kenny",5,Away
1986-09-13,1986,Liverpool,Charlton Athletic,2-0,2,0,1,1,2,2,H,"Dalglish, Kenny",2,Anfield
1986-09-20,1986,Southampton,Liverpool,2-1,2,1,1,1,3,1,H,"Dalglish, Kenny",1,Away
1986-09-27,1986,Liverpool,Aston Villa,3-3,3,3,1,1,6,0,D,"Dalglish, Kenny",3,Anfield
1986-10-04,1986,Wimbledon,Liverpool,1-3,1,3,1,1,4,-2,A,"Dalglish, Kenny",3,Away
1986-10-11,1986,Liverpool,Tottenham Hotspur,0-1,0,1,1,1,1,-1,A,"Dalglish, Kenny",0,Anfield
1986-10-18,1986,Liverpool,Oxford United,4-0,4,0,1,1,4,4,H,"Dalglish, Kenny",4,Anfield
1986-10-25,1986,Luton Town,Liverpool,4-1,4,1,1,1,5,3,H,"Dalglish, Kenny",1,Away
1986-11-01,1986,Liverpool,Norwich City,6-2,6,2,1,1,8,4,H,"Dalglish, Kenny",6,Anfield
1986-11-08,1986,Queens Park Rangers,Liverpool,1-3,1,3,1,1,4,-2,A,"Dalglish, Kenny",3,Away
1986-11-16,1986,Liverpool,Sheffield Wednesday,1-1,1,1,1,1,2,0,D,"Dalglish, Kenny",1,Anfield
1986-11-23,1986,Everton,Liverpool,0-0,0,0,1,1,0,0,D,"Dalglish, Kenny",0,Away
1986-11-29,1986,Liverpool,Coventry City,2-0,2,0,1,1,2,2,H,"Dalglish, Kenny",2,Anfield
1986-12-06,1986,Watford,Liverpool,2-0,2,0,1,1,2,2,H,"Dalglish, Kenny",0,Away
1986-12-14,1986,Liverpool,Chelsea,3-0,3,0,1,1,3,3,H,"Dalglish, Kenny",3,Anfield
1986-12-20,1986,Charlton Athletic,Liverpool,0-0,0,0,1,1,0,0,D,"Dalglish, Kenny",0,Away
1986-12-26,1986,Liverpool,Manchester United,0-1,0,1,1,1,1,-1,A,"Dalglish, Kenny",0,Anfield
1986-12-27,1986,Sheffield Wednesday,Liverpool,0-1,0,1,1,1,1,-1,A,"Dalglish, Kenny",1,Away
1987-01-01,1986,Nottingham Forest,Liverpool,1-1,1,1,1,1,2,0,D,"Dalglish, Kenny",1,Away
1987-01-03,1986,Liverpool,West Ham United,1-0,1,0,1,1,1,1,H,"Dalglish, Kenny",1,Anfield
1987-01-17,1986,Manchester City,Liverpool,0-1,0,1,1,1,1,-1,A,"Dalglish, Kenny",1,Away
1987-01-24,1986,Liverpool,Newcastle United,2-0,2,0,1,1,2,2,H,"Dalglish, Kenny",2,Anfield
1987-02-14,1986,Liverpool,Leicester City,4-3,4,3,1,1,7,1,H,"Dalglish, Kenny",4,Anfield
1987-02-21,1986,Aston Villa,Liverpool,2-2,2,2,1,1,4,0,D,"Dalglish, Kenny",2,Away
1987-02-28,1986,Liverpool,Southampton,1-0,1,0,1,1,1,1,H,"Dalglish, Kenny",1,Anfield
1987-03-07,1986,Liverpool,Luton Town,2-0,2,0,1,1,2,2,H,"Dalglish, Kenny",2,Anfield
1987-03-10,1986,Arsenal,Liverpool,0-1,0,1,1,1,1,-1,A,"Dalglish, Kenny",1,Away
1987-03-14,1986,Oxford United,Liverpool,1-3,1,3,1,1,4,-2,A,"Dalglish, Kenny",3,Away
1987-03-18,1986,Liverpool,Queens Park Rangers,2-1,2,1,1,1,3,1,H,"Dalglish, Kenny",2,Anfield
1987-03-22,1986,Tottenham Hotspur,Liverpool,1-0,1,0,1,1,1,1,H,"Dalglish, Kenny",0,Away
1987-03-28,1986,Liverpool,Wimbledon,1-2,1,2,1,1,3,-1,A,"Dalglish, Kenny",1,Anfield
1987-04-11,1986,Norwich City,Liverpool,2-1,2,1,1,1,3,1,H,"Dalglish, Kenny",1,Away
1987-04-18,1986,Liverpool,Nottingham Forest,3-0,3,0,1,1,3,3,H,"Dalglish, Kenny",3,Anfield
1987-04-20,1986,Manchester United,Liverpool,1-0,1,0,1,1,1,1,H,"Dalglish, Kenny",0,Away
1987-04-25,1986,Liverpool,Everton,3-1,3,1,1,1,4,2,H,"Dalglish, Kenny",3,Anfield
1987-05-02,1986,Coventry City,Liverpool,1-0,1,0,1,1,1,1,H,"Dalglish, Kenny",0,Away
1987-05-04,1986,Liverpool,Watford,1-0,1,0,1,1,1,1,H,"Dalglish, Kenny",1,Anfield
1987-05-09,1986,Chelsea,Liverpool,3-3,3,3,1,1,6,0,D,"Dalglish, Kenny",3,Away
1987-08-15,1987,Arsenal,Liverpool,1-2,1,2,1,1,3,-1,A,"Dalglish, Kenny",2,Away
1987-08-29,1987,Coventry City,Liverpool,1-4,1,4,1,1,5,-3,A,"Dalglish, Kenny",4,Away
1987-09-05,1987,West Ham United,Liverpool,1-1,1,1,1,1,2,0,D,"Dalglish, Kenny",1,Away
1987-09-12,1987,Liverpool,Oxford United,2-0,2,0,1,1,2,2,H,"Dalglish, Kenny",2,Anfield
1987-09-15,1987,Liverpool,Charlton Athletic,3-2,3,2,1,1,5,1,H,"Dalglish, Kenny",3,Anfield
1987-09-20,1987,Newcastle United,Liverpool,1-4,1,4,1,1,5,-3,A,"Dalglish, Kenny",4,Away
1987-09-29,1987,Liverpool,Derby County,4-0,4,0,1,1,4,4,H,"Dalglish, Kenny",4,Anfield
1987-10-03,1987,Liverpool,Portsmouth,4-0,4,0,1,1,4,4,H,"Dalglish, Kenny",4,Anfield
1987-10-17,1987,Liverpool,Queens Park Rangers,4-0,4,0,1,1,4,4,H,"Dalglish, Kenny",4,Anfield
1987-10-24,1987,Luton Town,Liverpool,0-1,0,1,1,1,1,-1,A,"Dalglish, Kenny",1,Away
1987-11-01,1987,Liverpool,Everton,2-0,2,0,1,1,2,2,H,"Dalglish, Kenny",2,Anfield
1987-11-04,1987,Wimbledon,Liverpool,1-1,1,1,1,1,2,0,D,"Dalglish, Kenny",1,Away
1987-11-15,1987,Manchester United,Liverpool,1-1,1,1,1,1,2,0,D,"Dalglish, Kenny",1,Away
1987-11-21,1987,Liverpool,Norwich City,0-0,0,0,1,1,0,0,D,"Dalglish, Kenny",0,Anfield
1987-11-24,1987,Liverpool,Watford,4-0,4,0,1,1,4,4,H,"Dalglish, Kenny",4,Anfield
1987-11-28,1987,Tottenham Hotspur,Liverpool,0-2,0,2,1,1,2,-2,A,"Dalglish, Kenny",2,Away
1987-12-06,1987,Liverpool,Chelsea,2-1,2,1,1,1,3,1,H,"Dalglish, Kenny",2,Anfield
1987-12-12,1987,Southampton,Liverpool,2-2,2,2,1,1,4,0,D,"Dalglish, Kenny",2,Away
1987-12-19,1987,Liverpool,Sheffield Wednesday,1-0,1,0,1,1,1,1,H,"Dalglish, Kenny",1,Anfield
1987-12-26,1987,Oxford United,Liverpool,0-3,0,3,1,1,3,-3,A,"Dalglish, Kenny",3,Away
1987-12-28,1987,Liverpool,Newcastle United,4-0,4,0,1,1,4,4,H,"Dalglish, Kenny",4,Anfield
1988-01-01,1987,Liverpool,Coventry City,4-0,4,0,1,1,4,4,H,"Dalglish, Kenny",4,Anfield
1988-01-16,1987,Liverpool,Arsenal,2-0,2,0,1,1,2,2,H,"Dalglish, Kenny",2,Anfield
1988-01-23,1987,Charlton Athletic,Liverpool,0-2,0,2,1,1,2,-2,A,"Dalglish, Kenny",2,Away
1988-02-06,1987,Liverpool,West Ham United,0-0,0,0,1,1,0,0,D,"Dalglish, Kenny",0,Anfield
1988-02-13,1987,Watford,Liverpool,1-4,1,4,1,1,5,-3,A,"Dalglish, Kenny",4,Away
1988-02-27,1987,Portsmouth,Liverpool,0-2,0,2,1,1,2,-2,A,"Dalglish, Kenny",2,Away
1988-03-05,1987,Queens Park Rangers,Liverpool,0-1,0,1,1,1,1,-1,A,"Dalglish, Kenny",1,Away
1988-03-16,1987,Derby County,Liverpool,1-1,1,1,1,1,2,0,D,"Dalglish, Kenny",1,Away
1988-03-20,1987,Everton,Liverpool,1-0,1,0,1,1,1,1,H,"Dalglish, Kenny",0,Away
1988-03-26,1987,Liverpool,Wimbledon,2-1,2,1,1,1,3,1,H,"Dalglish, Kenny",2,Anfield
1988-04-02,1987,Nottingham Forest,Liverpool,2-1,2,1,1,1,3,1,H,"Dalglish, Kenny",1,Away
1988-04-04,1987,Liverpool,Manchester United,3-3,3,3,1,1,6,0,D,"Dalglish, Kenny",3,Anfield
1988-04-13,1987,Liverpool,Nottingham Forest,5-0,5,0,1,1,5,5,H,"Dalglish, Kenny",5,Anfield
1988-04-20,1987,Norwich City,Liverpool,0-0,0,0,1,1,0,0,D,"Dalglish, Kenny",0,Away
1988-04-23,1987,Liverpool,Tottenham Hotspur,1-0,1,0,1,1,1,1,H,"Dalglish, Kenny",1,Anfield
1988-04-30,1987,Chelsea,Liverpool,1-1,1,1,1,1,2,0,D,"Dalglish, Kenny",1,Away
1988-05-02,1987,Liverpool,Southampton,1-1,1,1,1,1,2,0,D,"Dalglish, Kenny",1,Anfield
1988-05-07,1987,Sheffield Wednesday,Liverpool,1-5,1,5,1,1,6,-4,A,"Dalglish, Kenny",5,Away
1988-05-09,1987,Liverpool,Luton Town,1-1,1,1,1,1,2,0,D,"Dalglish, Kenny",1,Anfield
1988-08-27,1988,Charlton Athletic,Liverpool,0-3,0,3,1,1,3,-3,A,"Dalglish, Kenny",3,Away
1988-09-03,1988,Liverpool,Manchester United,1-0,1,0,1,1,1,1,H,"Dalglish, Kenny",1,Anfield
1988-09-10,1988,Aston Villa,Liverpool,1-1,1,1,1,1,2,0,D,"Dalglish, Kenny",1,Away
1988-09-17,1988,Liverpool,Tottenham Hotspur,1-1,1,1,1,1,2,0,D,"Dalglish, Kenny",1,Anfield
1988-09-24,1988,Southampton,Liverpool,1-3,1,3,1,1,4,-2,A,"Dalglish, Kenny",3,Away
1988-10-01,1988,Liverpool,Newcastle United,1-2,1,2,1,1,3,-1,A,"Dalglish, Kenny",1,Anfield
1988-10-08,1988,Luton Town,Liverpool,1-0,1,0,1,1,1,1,H,"Dalglish, Kenny",0,Away
1988-10-22,1988,Liverpool,Coventry City,0-0,0,0,1,1,0,0,D,"Dalglish, Kenny",0,Anfield
1988-10-26,1988,Nottingham Forest,Liverpool,2-1,2,1,1,1,3,1,H,"Dalglish, Kenny",1,Away
1988-10-29,1988,West Ham United,Liverpool,0-2,0,2,1,1,2,-2,A,"Dalglish, Kenny",2,Away
1988-11-05,1988,Liverpool,Middlesbrough,3-0,3,0,1,1,3,3,H,"Dalglish, Kenny",3,Anfield
1988-11-12,1988,Liverpool,Millwall,1-1,1,1,1,1,2,0,D,"Dalglish, Kenny",1,Anfield
1988-11-19,1988,Queens Park Rangers,Liverpool,0-1,0,1,1,1,1,-1,A,"Dalglish, Kenny",1,Away
1988-11-26,1988,Liverpool,Wimbledon,1-1,1,1,1,1,2,0,D,"Dalglish, Kenny",1,Anfield
1988-12-04,1988,Arsenal,Liverpool,1-1,1,1,1,1,2,0,D,"Dalglish, Kenny",1,Away
1988-12-11,1988,Liverpool,Everton,1-1,1,1,1,1,2,0,D,"Dalglish, Kenny",1,Anfield
1988-12-17,1988,Liverpool,Norwich City,0-1,0,1,1,1,1,-1,A,"Dalglish, Kenny",0,Anfield
1988-12-26,1988,Derby County,Liverpool,0-1,0,1,1,1,1,-1,A,"Dalglish, Kenny",1,Away
1989-01-01,1988,Manchester United,Liverpool,3-1,3,1,1,1,4,2,H,"Dalglish, Kenny",1,Away
1989-01-03,1988,Liverpool,Aston Villa,1-0,1,0,1,1,1,1,H,"Dalglish, Kenny",1,Anfield
1989-01-14,1988,Sheffield Wednesday,Liverpool,2-2,2,2,1,1,4,0,D,"Dalglish, Kenny",2,Away
1989-01-21,1988,Liverpool,Southampton,2-0,2,0,1,1,2,2,H,"Dalglish, Kenny",2,Anfield
1989-02-04,1988,Newcastle United,Liverpool,2-2,2,2,1,1,4,0,D,"Dalglish, Kenny",2,Away
1989-03-01,1988,Liverpool,Charlton Athletic,2-0,2,0,1,1,2,2,H,"Dalglish, Kenny",2,Anfield
1989-03-11,1988,Middlesbrough,Liverpool,0-4,0,4,1,1,4,-4,A,"Dalglish, Kenny",4,Away
1989-03-14,1988,Liverpool,Luton Town,5-0,5,0,1,1,5,5,H,"Dalglish, Kenny",5,Anfield
1989-03-22,1988,Coventry City,Liverpool,1-3,1,3,1,1,4,-2,A,"Dalglish, Kenny",3,Away
1989-03-26,1988,Tottenham Hotspur,Liverpool,1-2,1,2,1,1,3,-1,A,"Dalglish, Kenny",2,Away
1989-03-29,1988,Liverpool,Derby County,1-0,1,0,1,1,1,1,H,"Dalglish, Kenny",1,Anfield
1989-04-01,1988,Norwich City,Liverpool,0-1,0,1,1,1,1,-1,A,"Dalglish, Kenny",1,Away
1989-04-08,1988,Liverpool,Sheffield Wednesday,5-1,5,1,1,1,6,4,H,"Dalglish, Kenny",5,Anfield
1989-04-11,1988,Millwall,Liverpool,1-2,1,2,1,1,3,-1,A,"Dalglish, Kenny",2,Away
1989-05-03,1988,Everton,Liverpool,0-0,0,0,1,1,0,0,D,"Dalglish, Kenny",0,Away
1989-05-10,1988,Liverpool,Nottingham Forest,1-0,1,0,1,1,1,1,H,"Dalglish, Kenny",1,Anfield
1989-05-13,1988,Wimbledon,Liverpool,1-2,1,2,1,1,3,-1,A,"Dalglish, Kenny",2,Away
1989-05-16,1988,Liverpool,Queens Park Rangers,2-0,2,0,1,1,2,2,H,"Dalglish, Kenny",2,Anfield
1989-05-23,1988,Liverpool,West Ham United,5-1,5,1,1,1,6,4,H,"Dalglish, Kenny",5,Anfield
1989-05-26,1988,Liverpool,Arsenal,0-2,0,2,1,1,2,-2,A,"Dalglish, Kenny",0,Anfield
1989-08-19,1989,Liverpool,Manchester City,3-1,3,1,1,1,4,2,H,"Dalglish, Kenny",3,Anfield
1989-08-23,1989,Aston Villa,Liverpool,1-1,1,1,1,1,2,0,D,"Dalglish, Kenny",1,Away
1989-08-26,1989,Luton Town,Liverpool,0-0,0,0,1,1,0,0,D,"Dalglish, Kenny",0,Away
1989-09-09,1989,Derby County,Liverpool,0-3,0,3,1,1,3,-3,A,"Dalglish, Kenny",3,Away
1989-09-12,1989,Liverpool,Crystal Palace,9-0,9,0,1,1,9,9,H,"Dalglish, Kenny",9,Anfield
1989-09-16,1989,Liverpool,Norwich City,0-0,0,0,1,1,0,0,D,"Dalglish, Kenny",0,Anfield
1989-09-23,1989,Everton,Liverpool,1-3,1,3,1,1,4,-2,A,"Dalglish, Kenny",3,Away
1989-10-14,1989,Wimbledon,Liverpool,1-2,1,2,1,1,3,-1,A,"Dalglish, Kenny",2,Away
1989-10-21,1989,Southampton,Liverpool,4-1,4,1,1,1,5,3,H,"Dalglish, Kenny",1,Away
1989-10-29,1989,Liverpool,Tottenham Hotspur,1-0,1,0,1,1,1,1,H,"Dalglish, Kenny",1,Anfield
1989-11-04,1989,Liverpool,Coventry City,0-1,0,1,1,1,1,-1,A,"Dalglish, Kenny",0,Anfield
1989-11-11,1989,Queens Park Rangers,Liverpool,3-2,3,2,1,1,5,1,H,"Dalglish, Kenny",2,Away
1989-11-19,1989,Millwall,Liverpool,1-2,1,2,1,1,3,-1,A,"Dalglish, Kenny",2,Away
1989-11-26,1989,Liverpool,Arsenal,2-1,2,1,1,1,3,1,H,"Dalglish, Kenny",2,Anfield
1989-11-29,1989,Sheffield Wednesday,Liverpool,2-0,2,0,1,1,2,2,H,"Dalglish, Kenny",0,Away
1989-12-02,1989,Manchester City,Liverpool,1-4,1,4,1,1,5,-3,A,"Dalglish, Kenny",4,Away
1989-12-09,1989,Liverpool,Aston Villa,1-1,1,1,1,1,2,0,D,"Dalglish, Kenny",1,Anfield
1989-12-16,1989,Chelsea,Liverpool,2-5,2,5,1,1,7,-3,A,"Dalglish, Kenny",5,Away
1989-12-23,1989,Liverpool,Manchester United,0-0,0,0,1,1,0,0,D,"Dalglish, Kenny",0,Anfield
1989-12-26,1989,Liverpool,Sheffield Wednesday,2-1,2,1,1,1,3,1,H,"Dalglish, Kenny",2,Anfield
1989-12-30,1989,Liverpool,Charlton Athletic,1-0,1,0,1,1,1,1,H,"Dalglish, Kenny",1,Anfield
1990-01-01,1989,Nottingham Forest,Liverpool,2-2,2,2,1,1,4,0,D,"Dalglish, Kenny",2,Away
1990-01-13,1989,Liverpool,Luton Town,2-2,2,2,1,1,4,0,D,"Dalglish, Kenny",2,Anfield
1990-01-20,1989,Crystal Palace,Liverpool,0-2,0,2,1,1,2,-2,A,"Dalglish, Kenny",2,Away
1990-02-03,1989,Liverpool,Everton,2-1,2,1,1,1,3,1,H,"Dalglish, Kenny",2,Anfield
1990-02-10,1989,Norwich City,Liverpool,0-0,0,0,1,1,0,0,D,"Dalglish, Kenny",0,Away
1990-03-03,1989,Liverpool,Millwall,1-0,1,0,1,1,1,1,H,"Dalglish, Kenny",1,Anfield
1990-03-18,1989,Manchester United,Liverpool,1-2,1,2,1,1,3,-1,A,"Dalglish, Kenny",2,Away
1990-03-21,1989,Tottenham Hotspur,Liverpool,1-0,1,0,1,1,1,1,H,"Dalglish, Kenny",0,Away
1990-03-31,1989,Liverpool,Southampton,3-2,3,2,1,1,5,1,H,"Dalglish, Kenny",3,Anfield
1990-04-03,1989,Liverpool,Wimbledon,2-1,2,1,1,1,3,1,H,"Dalglish, Kenny",2,Anfield
1990-04-11,1989,Charlton Athletic,Liverpool,0-4,0,4,1,1,4,-4,A,"Dalglish, Kenny",4,Away
1990-04-14,1989,Liverpool,Nottingham Forest,2-2,2,2,1,1,4,0,D,"Dalglish, Kenny",2,Anfield
1990-04-18,1989,Arsenal,Liverpool,1-1,1,1,1,1,2,0,D,"Dalglish, Kenny",1,Away
1990-04-21,1989,Liverpool,Chelsea,4-1,4,1,1,1,5,3,H,"Dalglish, Kenny",4,Anfield
1990-04-28,1989,Liverpool,Queens Park Rangers,2-1,2,1,1,1,3,1,H,"Dalglish, Kenny",2,Anfield
1990-05-01,1989,Liverpool,Derby County,1-0,1,0,1,1,1,1,H,"Dalglish, Kenny",1,Anfield
1990-05-05,1989,Coventry City,Liverpool,1-6,1,6,1,1,7,-5,A,"Dalglish, Kenny",6,Away
1990-08-25,1990,Sheffield United,Liverpool,1-3,1,3,1,1,4,-2,A,"Dalglish, Kenny",3,Away
1990-08-28,1990,Liverpool,Nottingham Forest,2-0,2,0,1,1,2,2,H,"Dalglish, Kenny",2,Anfield
1990-09-01,1990,Liverpool,Aston Villa,2-1,2,1,1,1,3,1,H,"Dalglish, Kenny",2,Anfield
1990-09-08,1990,Wimbledon,Liverpool,1-2,1,2,1,1,3,-1,A,"Dalglish, Kenny",2,Away
1990-09-16,1990,Liverpool,Manchester United,4-0,4,0,1,1,4,4,H,"Dalglish, Kenny",4,Anfield
1990-09-22,1990,Everton,Liverpool,2-3,2,3,1,1,5,-1,A,"Dalglish, Kenny",3,Away
1990-09-29,1990,Sunderland,Liverpool,0-1,0,1,1,1,1,-1,A,"Dalglish, Kenny",1,Away
1990-10-06,1990,Liverpool,Derby County,2-0,2,0,1,1,2,2,H,"Dalglish, Kenny",2,Anfield
1990-10-20,1990,Norwich City,Liverpool,1-1,1,1,1,1,2,0,D,"Dalglish, Kenny",1,Away
1990-10-27,1990,Liverpool,Chelsea,2-0,2,0,1,1,2,2,H,"Dalglish, Kenny",2,Anfield
1990-11-04,1990,Tottenham Hotspur,Liverpool,1-3,1,3,1,1,4,-2,A,"Dalglish, Kenny",3,Away
1990-11-10,1990,Liverpool,Luton Town,4-0,4,0,1,1,4,4,H,"Dalglish, Kenny",4,Anfield
1990-11-17,1990,Coventry City,Liverpool,0-1,0,1,1,1,1,-1,A,"Dalglish, Kenny",1,Away
1990-11-24,1990,Liverpool,Manchester City,2-2,2,2,1,1,4,0,D,"Dalglish, Kenny",2,Anfield
1990-12-02,1990,Arsenal,Liverpool,3-0,3,0,1,1,3,3,H,"Dalglish, Kenny",0,Away
1990-12-15,1990,Liverpool,Sheffield United,2-0,2,0,1,1,2,2,H,"Dalglish, Kenny",2,Anfield
1990-12-22,1990,Liverpool,Southampton,3-2,3,2,1,1,5,1,H,"Dalglish, Kenny",3,Anfield
1990-12-26,1990,Queens Park Rangers,Liverpool,1-1,1,1,1,1,2,0,D,"Dalglish, Kenny",1,Away
1990-12-30,1990,Crystal Palace,Liverpool,1-0,1,0,1,1,1,1,H,"Dalglish, Kenny",0,Away
1991-01-01,1990,Liverpool,Leeds United,3-0,3,0,1,1,3,3,H,"Dalglish, Kenny",3,Anfield
1991-01-12,1990,Aston Villa,Liverpool,0-0,0,0,1,1,0,0,D,"Dalglish, Kenny",0,Away
1991-01-19,1990,Liverpool,Wimbledon,1-1,1,1,1,1,2,0,D,"Dalglish, Kenny",1,Anfield
1991-02-03,1990,Manchester United,Liverpool,1-1,1,1,1,1,2,0,D,"Dalglish, Kenny",1,Away
1991-02-09,1990,Liverpool,Everton,3-1,3,1,1,1,4,2,H,"Dalglish, Kenny",3,Anfield
1991-02-23,1990,Luton Town,Liverpool,3-1,3,1,1,1,4,2,H,"Moran, Ronnie",1,Away
1991-03-03,1990,Liverpool,Arsenal,0-1,0,1,1,1,1,-1,A,"Moran, Ronnie",0,Anfield
1991-03-09,1990,Manchester City,Liverpool,0-3,0,3,1,1,3,-3,A,"Moran, Ronnie",3,Away
1991-03-16,1990,Liverpool,Sunderland,2-1,2,1,1,1,3,1,H,"Moran, Ronnie",2,Anfield
1991-03-23,1990,Derby County,Liverpool,1-7,1,7,1,1,8,-6,A,"Moran, Ronnie",7,Away
1991-03-30,1990,Liverpool,Queens Park Rangers,1-3,1,3,1,1,4,-2,A,"Moran, Ronnie",1,Anfield
1991-04-01,1990,Southampton,Liverpool,1-0,1,0,1,1,1,1,H,"Moran, Ronnie",0,Away
1991-04-09,1990,Liverpool,Coventry City,1-1,1,1,1,1,2,0,D,"Moran, Ronnie",1,Anfield
1991-04-13,1990,Leeds United,Liverpool,4-5,4,5,1,1,9,-1,A,"Moran, Ronnie",5,Away
1991-04-20,1990,Liverpool,Norwich City,3-0,3,0,1,1,3,3,H,"Souness, Graeme",3,Anfield
1991-04-23,1990,Liverpool,Crystal Palace,3-0,3,0,1,1,3,3,H,"Souness, Graeme",3,Anfield
1991-05-04,1990,Chelsea,Liverpool,4-2,4,2,1,1,6,2,H,"Souness, Graeme",2,Away
1991-05-06,1990,Nottingham Forest,Liverpool,2-1,2,1,1,1,3,1,H,"Souness, Graeme",1,Away
1991-05-11,1990,Liverpool,Tottenham Hotspur,2-0,2,0,1,1,2,2,H,"Souness, Graeme",2,Anfield
1991-08-17,1991,Liverpool,Oldham Athletic,2-1,2,1,1,1,3,1,H,"Souness, Graeme",2,Anfield
1991-08-21,1991,Manchester City,Liverpool,2-1,2,1,1,1,3,1,H,"Souness, Graeme",1,Away
1991-08-24,1991,Luton Town,Liverpool,0-0,0,0,1,1,0,0,D,"Souness, Graeme",0,Away
1991-08-27,1991,Liverpool,Queens Park Rangers,1-0,1,0,1,1,1,1,H,"Souness, Graeme",1,Anfield
1991-08-31,1991,Liverpool,Everton,3-1,3,1,1,1,4,2,H,"Souness, Graeme",3,Anfield
1991-09-07,1991,Notts County,Liverpool,1-2,1,2,1,1,3,-1,A,"Souness, Graeme",2,Away
1991-09-14,1991,Liverpool,Aston Villa,1-1,1,1,1,1,2,0,D,"Souness, Graeme",1,Anfield
1991-09-21,1991,Leeds United,Liverpool,1-0,1,0,1,1,1,1,H,"Souness, Graeme",0,Away
1991-09-28,1991,Liverpool,Sheffield Wednesday,1-1,1,1,1,1,2,0,D,"Souness, Graeme",1,Anfield
1991-10-06,1991,Manchester United,Liverpool,0-0,0,0,1,1,0,0,D,"Souness, Graeme",0,Away
1991-10-19,1991,Chelsea,Liverpool,2-2,2,2,1,1,4,0,D,"Souness, Graeme",2,Away
1991-10-26,1991,Liverpool,Coventry City,1-0,1,0,1,1,1,1,H,"Souness, Graeme",1,Anfield
1991-11-02,1991,Liverpool,Crystal Palace,1-2,1,2,1,1,3,-1,A,"Souness, Graeme",1,Anfield
1991-11-17,1991,West Ham United,Liverpool,0-0,0,0,1,1,0,0,D,"Souness, Graeme",0,Away
1991-11-23,1991,Wimbledon,Liverpool,0-0,0,0,1,1,0,0,D,"Souness, Graeme",0,Away
1991-11-30,1991,Liverpool,Norwich City,2-1,2,1,1,1,3,1,H,"Souness, Graeme",2,Anfield
1991-12-07,1991,Southampton,Liverpool,1-1,1,1,1,1,2,0,D,"Souness, Graeme",1,Away
1991-12-14,1991,Liverpool,Nottingham Forest,2-0,2,0,1,1,2,2,H,"Souness, Graeme",2,Anfield
1991-12-18,1991,Tottenham Hotspur,Liverpool,1-2,1,2,1,1,3,-1,A,"Souness, Graeme",2,Away
1991-12-21,1991,Liverpool,Manchester City,2-2,2,2,1,1,4,0,D,"Souness, Graeme",2,Anfield
1991-12-26,1991,Queens Park Rangers,Liverpool,0-0,0,0,1,1,0,0,D,"Souness, Graeme",0,Away
1991-12-28,1991,Everton,Liverpool,1-1,1,1,1,1,2,0,D,"Souness, Graeme",1,Away
1992-01-01,1991,Liverpool,Sheffield United,2-1,2,1,1,1,3,1,H,"Souness, Graeme",2,Anfield
1992-01-11,1991,Liverpool,Luton Town,2-1,2,1,1,1,3,1,H,"Souness, Graeme",2,Anfield
1992-01-18,1991,Oldham Athletic,Liverpool,2-3,2,3,1,1,5,-1,A,"Souness, Graeme",3,Away
1992-01-29,1991,Liverpool,Arsenal,2-0,2,0,1,1,2,2,H,"Souness, Graeme",2,Anfield
1992-02-01,1991,Liverpool,Chelsea,1-2,1,2,1,1,3,-1,A,"Souness, Graeme",1,Anfield
1992-02-08,1991,Coventry City,Liverpool,0-0,0,0,1,1,0,0,D,"Souness, Graeme",0,Away
1992-02-22,1991,Norwich City,Liverpool,3-0,3,0,1,1,3,3,H,"Souness, Graeme",0,Away
1992-02-29,1991,Liverpool,Southampton,0-0,0,0,1,1,0,0,D,"Souness, Graeme",0,Anfield
1992-03-11,1991,Liverpool,West Ham United,1-0,1,0,1,1,1,1,H,"Souness, Graeme",1,Anfield
1992-03-14,1991,Crystal Palace,Liverpool,1-0,1,0,1,1,1,1,H,"Souness, Graeme",0,Away
1992-03-21,1991,Liverpool,Tottenham Hotspur,2-1,2,1,1,1,3,1,H,"Souness, Graeme",2,Anfield
1992-03-28,1991,Sheffield United,Liverpool,2-0,2,0,1,1,2,2,H,"Souness, Graeme",0,Away
1992-03-31,1991,Liverpool,Notts County,4-0,4,0,1,1,4,4,H,"Souness, Graeme",4,Anfield
1992-04-08,1991,Liverpool,Wimbledon,2-3,2,3,1,1,5,-1,A,"Souness, Graeme",2,Anfield
1992-04-11,1991,Aston Villa,Liverpool,1-0,1,0,1,1,1,1,H,"Souness, Graeme",0,Away
1992-04-18,1991,Liverpool,Leeds United,0-0,0,0,1,1,0,0,D,"Souness, Graeme",0,Anfield
1992-04-20,1991,Arsenal,Liverpool,4-0,4,0,1,1,4,4,H,"Souness, Graeme",0,Away
1992-04-22,1991,Nottingham Forest,Liverpool,1-1,1,1,1,1,2,0,D,"Souness, Graeme",1,Away
1992-04-26,1991,Liverpool,Manchester United,2-0,2,0,1,1,2,2,H,"Souness, Graeme",2,Anfield
1992-05-02,1991,Sheffield Wednesday,Liverpool,0-0,0,0,1,1,0,0,D,"Souness, Graeme",0,Away
1992-08-16,1992,Nottingham Forest,Liverpool,1-0,1,0,1,1,1,1,H,"Souness, Graeme",0,Away
1992-08-19,1992,Liverpool,Sheffield United,2-1,2,1,1,1,3,1,H,"Souness, Graeme",2,Anfield
1992-08-23,1992,Liverpool,Arsenal,0-2,0,2,1,1,2,-2,A,"Souness, Graeme",0,Anfield
1992-08-25,1992,Ipswich Town,Liverpool,2-2,2,2,1,1,4,0,D,"Souness, Graeme",2,Away
1992-08-29,1992,Leeds United,Liverpool,2-2,2,2,1,1,4,0,D,"Souness, Graeme",2,Away
1992-09-01,1992,Liverpool,Southampton,1-1,1,1,1,1,2,0,D,"Souness, Graeme",1,Anfield
1992-09-05,1992,Liverpool,Chelsea,2-1,2,1,1,1,3,1,H,"Souness, Graeme",2,Anfield
1992-09-12,1992,Sheffield United,Liverpool,1-0,1,0,1,1,1,1,H,"Souness, Graeme",0,Away
1992-09-19,1992,Aston Villa,Liverpool,4-2,4,2,1,1,6,2,H,"Souness, Graeme",2,Away
1992-09-26,1992,Liverpool,Wimbledon,2-3,2,3,1,1,5,-1,A,"Souness, Graeme",2,Anfield
1992-10-03,1992,Liverpool,Sheffield Wednesday,1-0,1,0,1,1,1,1,H,"Souness, Graeme",1,Anfield
1992-10-18,1992,Manchester United,Liverpool,2-2,2,2,1,1,4,0,D,"Souness, Graeme",2,Away
1992-10-25,1992,Liverpool,Norwich City,4-1,4,1,1,1,5,3,H,"Souness, Graeme",4,Anfield
1992-10-31,1992,Tottenham Hotspur,Liverpool,2-0,2,0,1,1,2,2,H,"Souness, Graeme",0,Away
1992-11-07,1992,Liverpool,Middlesbrough,4-1,4,1,1,1,5,3,H,"Souness, Graeme",4,Anfield
1992-11-23,1992,Queens Park Rangers,Liverpool,0-1,0,1,1,1,1,-1,A,"Souness, Graeme",1,Away
1992-11-28,1992,Liverpool,Crystal Palace,5-0,5,0,1,1,5,5,H,"Souness, Graeme",5,Anfield
1992-12-07,1992,Everton,Liverpool,2-1,2,1,1,1,3,1,H,"Souness, Graeme",1,Away
1992-12-13,1992,Liverpool,Blackburn Rovers,2-1,2,1,1,1,3,1,H,"Souness, Graeme",2,Anfield
1992-12-19,1992,Coventry City,Liverpool,5-1,5,1,1,1,6,4,H,"Souness, Graeme",1,Away
1992-12-28,1992,Liverpool,Manchester City,1-1,1,1,1,1,2,0,D,"Souness, Graeme",1,Anfield
1993-01-09,1992,Liverpool,Aston Villa,1-2,1,2,1,1,3,-1,A,"Souness, Graeme",1,Anfield
1993-01-16,1992,Wimbledon,Liverpool,2-0,2,0,1,1,2,2,H,"Souness, Graeme",0,Away
1993-01-31,1992,Arsenal,Liverpool,0-1,0,1,1,1,1,-1,A,"Souness, Graeme",1,Away
1993-02-06,1992,Liverpool,Nottingham Forest,0-0,0,0,1,1,0,0,D,"Souness, Graeme",0,Anfield
1993-02-10,1992,Chelsea,Liverpool,0-0,0,0,1,1,0,0,D,"Souness, Graeme",0,Away
1993-02-13,1992,Southampton,Liverpool,2-1,2,1,1,1,3,1,H,"Souness, Graeme",1,Away
1993-02-20,1992,Liverpool,Ipswich Town,0-0,0,0,1,1,0,0,D,"Souness, Graeme",0,Anfield
1993-02-27,1992,Sheffield Wednesday,Liverpool,1-1,1,1,1,1,2,0,D,"Souness, Graeme",1,Away
1993-03-06,1992,Liverpool,Manchester United,1-2,1,2,1,1,3,-1,A,"Souness, Graeme",1,Anfield
1993-03-10,1992,Liverpool,Queens Park Rangers,1-0,1,0,1,1,1,1,H,"Souness, Graeme",1,Anfield
1993-03-13,1992,Middlesbrough,Liverpool,1-2,1,2,1,1,3,-1,A,"Souness, Graeme",2,Away
1993-03-20,1992,Liverpool,Everton,1-0,1,0,1,1,1,1,H,"Souness, Graeme",1,Anfield
1993-03-23,1992,Crystal Palace,Liverpool,1-1,1,1,1,1,2,0,D,"Souness, Graeme",1,Away
1993-04-03,1992,Blackburn Rovers,Liverpool,4-1,4,1,1,1,5,3,H,"Souness, Graeme",1,Away
1993-04-10,1992,Liverpool,Oldham Athletic,1-0,1,0,1,1,1,1,H,"Souness, Graeme",1,Anfield
1993-04-12,1992,Manchester City,Liverpool,1-1,1,1,1,1,2,0,D,"Souness, Graeme",1,Away
1993-04-17,1992,Liverpool,Coventry City,4-0,4,0,1,1,4,4,H,"Souness, Graeme",4,Anfield
1993-04-21,1992,Liverpool,Leeds United,2-0,2,0,1,1,2,2,H,"Souness, Graeme",2,Anfield
1993-05-01,1992,Norwich City,Liverpool,1-0,1,0,1,1,1,1,H,"Souness, Graeme",0,Away
1993-05-05,1992,Oldham Athletic,Liverpool,3-2,3,2,1,1,5,1,H,"Souness, Graeme",2,Away
1993-05-08,1992,Liverpool,Tottenham Hotspur,6-2,6,2,1,1,8,4,H,"Souness, Graeme",6,Anfield
1993-08-14,1993,Liverpool,Sheffield Wednesday,2-0,2,0,1,1,2,2,H,"Souness, Graeme",2,Anfield
1993-08-18,1993,Queens Park Rangers,Liverpool,1-3,1,3,1,1,4,-2,A,"Souness, Graeme",3,Away
1993-08-22,1993,Swindon Town,Liverpool,0-5,0,5,1,1,5,-5,A,"Souness, Graeme",5,Away
1993-08-25,1993,Liverpool,Tottenham Hotspur,1-2,1,2,1,1,3,-1,A,"Souness, Graeme",1,Anfield
1993-08-28,1993,Liverpool,Leeds United,2-0,2,0,1,1,2,2,H,"Souness, Graeme",2,Anfield
1993-09-01,1993,Coventry City,Liverpool,1-0,1,0,1,1,1,1,H,"Souness, Graeme",0,Away
1993-09-12,1993,Liverpool,Blackburn Rovers,0-1,0,1,1,1,1,-1,A,"Souness, Graeme",0,Anfield
1993-09-18,1993,Everton,Liverpool,2-0,2,0,1,1,2,2,H,"Souness, Graeme",0,Away
1993-09-25,1993,Chelsea,Liverpool,1-0,1,0,1,1,1,1,H,"Souness, Graeme",0,Away
1993-10-02,1993,Liverpool,Arsenal,0-0,0,0,1,1,0,0,D,"Souness, Graeme",0,Anfield
1993-10-16,1993,Liverpool,Oldham Athletic,2-1,2,1,1,1,3,1,H,"Souness, Graeme",2,Anfield
1993-10-23,1993,Manchester City,Liverpool,1-1,1,1,1,1,2,0,D,"Souness, Graeme",1,Away
1993-10-30,1993,Liverpool,Southampton,4-2,4,2,1,1,6,2,H,"Souness, Graeme",4,Anfield
1993-11-06,1993,Liverpool,West Ham United,2-0,2,0,1,1,2,2,H,"Souness, Graeme",2,Anfield
1993-11-21,1993,Newcastle United,Liverpool,3-0,3,0,1,1,3,3,H,"Souness, Graeme",0,Away
1993-11-28,1993,Liverpool,Aston Villa,2-1,2,1,1,1,3,1,H,"Souness, Graeme",2,Anfield
1993-12-04,1993,Sheffield Wednesday,Liverpool,3-1,3,1,1,1,4,2,H,"Souness, Graeme",1,Away
1993-12-08,1993,Liverpool,Queens Park Rangers,3-2,3,2,1,1,5,1,H,"Souness, Graeme",3,Anfield
1993-12-11,1993,Liverpool,Swindon Town,2-2,2,2,1,1,4,0,D,"Souness, Graeme",2,Anfield
1993-12-18,1993,Tottenham Hotspur,Liverpool,3-3,3,3,1,1,6,0,D,"Souness, Graeme",3,Away
1993-12-26,1993,Sheffield United,Liverpool,0-0,0,0,1,1,0,0,D,"Souness, Graeme",0,Away
1993-12-28,1993,Liverpool,Wimbledon,1-1,1,1,1,1,2,0,D,"Souness, Graeme",1,Anfield
1994-01-01,1993,Ipswich Town,Liverpool,1-2,1,2,1,1,3,-1,A,"Souness, Graeme",2,Away
1994-01-04,1993,Liverpool,Manchester United,3-3,3,3,1,1,6,0,D,"Souness, Graeme",3,Anfield
1994-01-15,1993,Oldham Athletic,Liverpool,0-3,0,3,1,1,3,-3,A,"Souness, Graeme",3,Away
1994-01-22,1993,Liverpool,Manchester City,2-1,2,1,1,1,3,1,H,"Souness, Graeme",2,Anfield
1994-02-05,1993,Norwich City,Liverpool,2-2,2,2,1,1,4,0,D,"Evans, Roy",2,Away
1994-02-14,1993,Southampton,Liverpool,4-2,4,2,1,1,6,2,H,"Evans, Roy",2,Away
1994-02-19,1993,Leeds United,Liverpool,2-0,2,0,1,1,2,2,H,"Evans, Roy",0,Away
1994-02-26,1993,Liverpool,Coventry City,1-0,1,0,1,1,1,1,H,"Evans, Roy",1,Anfield
1994-03-05,1993,Blackburn Rovers,Liverpool,2-0,2,0,1,1,2,2,H,"Evans, Roy",0,Away
1994-03-13,1993,Liverpool,Everton,2-1,2,1,1,1,3,1,H,"Evans, Roy",2,Anfield
1994-03-19,1993,Liverpool,Chelsea,2-1,2,1,1,1,3,1,H,"Evans, Roy",2,Anfield
1994-03-26,1993,Arsenal,Liverpool,1-0,1,0,1,1,1,1,H,"Evans, Roy",0,Away
1994-03-30,1993,Manchester United,Liverpool,1-0,1,0,1,1,1,1,H,"Evans, Roy",0,Away
1994-04-02,1993,Liverpool,Sheffield United,1-2,1,2,1,1,3,-1,A,"Evans, Roy",1,Anfield
1994-04-04,1993,Wimbledon,Liverpool,1-1,1,1,1,1,2,0,D,"Evans, Roy",1,Away
1994-04-09,1993,Liverpool,Ipswich Town,1-0,1,0,1,1,1,1,H,"Evans, Roy",1,Anfield
1994-04-16,1993,Liverpool,Newcastle United,0-2,0,2,1,1,2,-2,A,"Evans, Roy",0,Anfield
1994-04-23,1993,West Ham United,Liverpool,1-2,1,2,1,1,3,-1,A,"Evans, Roy",2,Away
1994-04-30,1993,Liverpool,Norwich City,0-1,0,1,1,1,1,-1,A,"Evans, Roy",0,Anfield
1994-05-07,1993,Aston Villa,Liverpool,2-1,2,1,1,1,3,1,H,"Evans, Roy",1,Away
1994-08-20,1994,Crystal Palace,Liverpool,1-6,1,6,1,1,7,-5,A,"Evans, Roy",6,Away
1994-08-28,1994,Liverpool,Arsenal,3-0,3,0,1,1,3,3,H,"Evans, Roy",3,Anfield
1994-08-31,1994,Southampton,Liverpool,0-2,0,2,1,1,2,-2,A,"Evans, Roy",2,Away
1994-09-10,1994,Liverpool,West Ham United,0-0,0,0,1,1,0,0,D,"Evans, Roy",0,Anfield
1994-09-17,1994,Manchester United,Liverpool,2-0,2,0,1,1,2,2,H,"Evans, Roy",0,Away
1994-09-24,1994,Newcastle United,Liverpool,1-1,1,1,1,1,2,0,D,"Evans, Roy",1,Away
1994-10-01,1994,Liverpool,Sheffield Wednesday,4-1,4,1,1,1,5,3,H,"Evans, Roy",4,Anfield
1994-10-08,1994,Liverpool,Aston Villa,3-2,3,2,1,1,5,1,H,"Evans, Roy",3,Anfield
1994-10-15,1994,Blackburn Rovers,Liverpool,3-2,3,2,1,1,5,1,H,"Evans, Roy",2,Away
1994-10-22,1994,Liverpool,Wimbledon,3-0,3,0,1,1,3,3,H,"Evans, Roy",3,Anfield
1994-10-29,1994,Ipswich Town,Liverpool,1-3,1,3,1,1,4,-2,A,"Evans, Roy",3,Away
1994-10-31,1994,Queens Park Rangers,Liverpool,2-1,2,1,1,1,3,1,H,"Evans, Roy",1,Away
1994-11-05,1994,Liverpool,Nottingham Forest,1-0,1,0,1,1,1,1,H,"Evans, Roy",1,Anfield
1994-11-09,1994,Liverpool,Chelsea,3-1,3,1,1,1,4,2,H,"Evans, Roy",3,Anfield
1994-11-21,1994,Everton,Liverpool,2-0,2,0,1,1,2,2,H,"Evans, Roy",0,Away
1994-11-26,1994,Liverpool,Tottenham Hotspur,1-1,1,1,1,1,2,0,D,"Evans, Roy",1,Anfield
1994-12-03,1994,Coventry City,Liverpool,1-1,1,1,1,1,2,0,D,"Evans, Roy",1,Away
1994-12-11,1994,Liverpool,Crystal Palace,0-0,0,0,1,1,0,0,D,"Evans, Roy",0,Anfield
1994-12-18,1994,Chelsea,Liverpool,0-0,0,0,1,1,0,0,D,"Evans, Roy",0,Away
1994-12-26,1994,Leicester City,Liverpool,1-2,1,2,1,1,3,-1,A,"Evans, Roy",2,Away
1994-12-28,1994,Liverpool,Manchester City,2-0,2,0,1,1,2,2,H,"Evans, Roy",2,Anfield
1994-12-31,1994,Leeds United,Liverpool,0-2,0,2,1,1,2,-2,A,"Evans, Roy",2,Away
1995-01-02,1994,Liverpool,Norwich City,4-0,4,0,1,1,4,4,H,"Evans, Roy",4,Anfield
1995-01-14,1994,Liverpool,Ipswich Town,0-1,0,1,1,1,1,-1,A,"Evans, Roy",0,Anfield
1995-01-24,1994,Liverpool,Everton,0-0,0,0,1,1,0,0,D,"Evans, Roy",0,Anfield
1995-02-04,1994,Nottingham Forest,Liverpool,1-1,1,1,1,1,2,0,D,"Evans, Roy",1,Away
1995-02-11,1994,Liverpool,Queens Park Rangers,1-1,1,1,1,1,2,0,D,"Evans, Roy",1,Anfield
1995-02-25,1994,Sheffield Wednesday,Liverpool,1-2,1,2,1,1,3,-1,A,"Evans, Roy",2,Away
1995-03-04,1994,Liverpool,Newcastle United,2-0,2,0,1,1,2,2,H,"Evans, Roy",2,Anfield
1995-03-14,1994,Liverpool,Coventry City,2-3,2,3,1,1,5,-1,A,"Evans, Roy",2,Anfield
1995-03-19,1994,Liverpool,Manchester United,2-0,2,0,1,1,2,2,H,"Evans, Roy",2,Anfield
1995-03-22,1994,Tottenham Hotspur,Liverpool,0-0,0,0,1,1,0,0,D,"Evans, Roy",0,Away
1995-04-05,1994,Liverpool,Southampton,3-1,3,1,1,1,4,2,H,"Evans, Roy",3,Anfield
1995-04-09,1994,Liverpool,Leeds United,0-1,0,1,1,1,1,-1,A,"Evans, Roy",0,Anfield
1995-04-12,1994,Arsenal,Liverpool,0-1,0,1,1,1,1,-1,A,"Evans, Roy",1,Away
1995-04-14,1994,Manchester City,Liverpool,2-1,2,1,1,1,3,1,H,"Evans, Roy",1,Away
1995-04-17,1994,Liverpool,Leicester City,2-0,2,0,1,1,2,2,H,"Evans, Roy",2,Anfield
1995-04-29,1994,Norwich City,Liverpool,1-2,1,2,1,1,3,-1,A,"Evans, Roy",2,Away
1995-05-02,1994,Wimbledon,Liverpool,0-0,0,0,1,1,0,0,D,"Evans, Roy",0,Away
1995-05-06,1994,Aston Villa,Liverpool,2-0,2,0,1,1,2,2,H,"Evans, Roy",0,Away
1995-05-10,1994,West Ham United,Liverpool,3-0,3,0,1,1,3,3,H,"Evans, Roy",0,Away
1995-05-14,1994,Liverpool,Blackburn Rovers,2-1,2,1,1,1,3,1,H,"Evans, Roy",2,Anfield
1995-08-19,1995,Liverpool,Sheffield Wednesday,1-0,1,0,1,1,1,1,H,"Evans, Roy",1,Anfield
1995-08-21,1995,Leeds United,Liverpool,1-0,1,0,1,1,1,1,H,"Evans, Roy",0,Away
1995-08-26,1995,Tottenham Hotspur,Liverpool,1-3,1,3,1,1,4,-2,A,"Evans, Roy",3,Away
1995-08-30,1995,Liverpool,Queens Park Rangers,1-0,1,0,1,1,1,1,H,"Evans, Roy",1,Anfield
1995-09-09,1995,Wimbledon,Liverpool,1-0,1,0,1,1,1,1,H,"Evans, Roy",0,Away
1995-09-16,1995,Liverpool,Blackburn Rovers,3-0,3,0,1,1,3,3,H,"Evans, Roy",3,Anfield
1995-09-23,1995,Liverpool,Bolton Wanderers,5-2,5,2,1,1,7,3,H,"Evans, Roy",5,Anfield
1995-10-01,1995,Manchester United,Liverpool,2-2,2,2,1,1,4,0,D,"Evans, Roy",2,Away
1995-10-14,1995,Liverpool,Coventry City,0-0,0,0,1,1,0,0,D,"Evans, Roy",0,Anfield
1995-10-22,1995,Southampton,Liverpool,1-3,1,3,1,1,4,-2,A,"Evans, Roy",3,Away
1995-10-28,1995,Liverpool,Manchester City,6-0,6,0,1,1,6,6,H,"Evans, Roy",6,Anfield
1995-11-04,1995,Newcastle United,Liverpool,2-1,2,1,1,1,3,1,H,"Evans, Roy",1,Away
1995-11-18,1995,Liverpool,Everton,1-2,1,2,1,1,3,-1,A,"Evans, Roy",1,Anfield
1995-11-22,1995,West Ham United,Liverpool,0-0,0,0,1,1,0,0,D,"Evans, Roy",0,Away
1995-11-25,1995,Middlesbrough,Liverpool,2-1,2,1,1,1,3,1,H,"Evans, Roy",1,Away
1995-12-02,1995,Liverpool,Southampton,1-1,1,1,1,1,2,0,D,"Evans, Roy",1,Anfield
1995-12-09,1995,Bolton Wanderers,Liverpool,0-1,0,1,1,1,1,-1,A,"Evans, Roy",1,Away
1995-12-17,1995,Liverpool,Manchester United,2-0,2,0,1,1,2,2,H,"Evans, Roy",2,Anfield
1995-12-23,1995,Liverpool,Arsenal,3-1,3,1,1,1,4,2,H,"Evans, Roy",3,Anfield
1995-12-30,1995,Chelsea,Liverpool,2-2,2,2,1,1,4,0,D,"Evans, Roy",2,Away
1996-01-01,1995,Liverpool,Nottingham Forest,4-2,4,2,1,1,6,2,H,"Evans, Roy",4,Anfield
1996-01-13,1995,Sheffield Wednesday,Liverpool,1-1,1,1,1,1,2,0,D,"Evans, Roy",1,Away
1996-01-20,1995,Liverpool,Leeds United,5-0,5,0,1,1,5,5,H,"Evans, Roy",5,Anfield
1996-01-31,1995,Aston Villa,Liverpool,0-2,0,2,1,1,2,-2,A,"Evans, Roy",2,Away
1996-02-03,1995,Liverpool,Tottenham Hotspur,0-0,0,0,1,1,0,0,D,"Evans, Roy",0,Anfield
1996-02-11,1995,Queens Park Rangers,Liverpool,1-2,1,2,1,1,3,-1,A,"Evans, Roy",2,Away
1996-02-24,1995,Blackburn Rovers,Liverpool,2-3,2,3,1,1,5,-1,A,"Evans, Roy",3,Away
1996-03-03,1995,Liverpool,Aston Villa,3-0,3,0,1,1,3,3,H,"Evans, Roy",3,Anfield
1996-03-13,1995,Liverpool,Wimbledon,2-2,2,2,1,1,4,0,D,"Evans, Roy",2,Anfield
1996-03-16,1995,Liverpool,Chelsea,2-0,2,0,1,1,2,2,H,"Evans, Roy",2,Anfield
1996-03-23,1995,Nottingham Forest,Liverpool,1-0,1,0,1,1,1,1,H,"Evans, Roy",0,Away
1996-04-03,1995,Liverpool,Newcastle United,4-3,4,3,1,1,7,1,H,"Evans, Roy",4,Anfield
1996-04-06,1995,Coventry City,Liverpool,1-0,1,0,1,1,1,1,H,"Evans, Roy",0,Away
1996-04-08,1995,Liverpool,West Ham United,2-0,2,0,1,1,2,2,H,"Evans, Roy",2,Anfield
1996-04-16,1995,Everton,Liverpool,1-1,1,1,1,1,2,0,D,"Evans, Roy",1,Away
1996-04-27,1995,Liverpool,Middlesbrough,1-0,1,0,1,1,1,1,H,"Evans, Roy",1,Anfield
1996-05-01,1995,Arsenal,Liverpool,0-0,0,0,1,1,0,0,D,"Evans, Roy",0,Away
1996-05-04,1995,Manchester City,Liverpool,2-2,2,2,1,1,4,0,D,"Evans, Roy",2,Away
1996-08-17,1996,Middlesbrough,Liverpool,3-3,3,3,1,1,6,0,D,"Evans, Roy",3,Away
1996-08-19,1996,Liverpool,Arsenal,2-0,2,0,1,1,2,2,H,"Evans, Roy",2,Anfield
1996-08-24,1996,Liverpool,Sunderland,0-0,0,0,1,1,0,0,D,"Evans, Roy",0,Anfield
1996-09-04,1996,Coventry City,Liverpool,0-1,0,1,1,1,1,-1,A,"Evans, Roy",1,Away
1996-09-07,1996,Liverpool,Southampton,2-1,2,1,1,1,3,1,H,"Evans, Roy",2,Anfield
1996-09-15,1996,Leicester City,Liverpool,0-3,0,3,1,1,3,-3,A,"Evans, Roy",3,Away
1996-09-21,1996,Liverpool,Chelsea,5-1,5,1,1,1,6,4,H,"Evans, Roy",5,Anfield
1996-09-29,1996,West Ham United,Liverpool,1-2,1,2,1,1,3,-1,A,"Evans, Roy",2,Away
1996-10-12,1996,Manchester United,Liverpool,1-0,1,0,1,1,1,1,H,"Evans, Roy",0,Away
1996-10-27,1996,Liverpool,Derby County,2-1,2,1,1,1,3,1,H,"Evans, Roy",2,Anfield
1996-11-03,1996,Blackburn Rovers,Liverpool,3-0,3,0,1,1,3,3,H,"Evans, Roy",0,Away
1996-11-16,1996,Leeds United,Liverpool,0-2,0,2,1,1,2,-2,A,"Evans, Roy",2,Away
1996-11-20,1996,Liverpool,Everton,1-1,1,1,1,1,2,0,D,"Evans, Roy",1,Anfield
1996-11-23,1996,Liverpool,Wimbledon,1-1,1,1,1,1,2,0,D,"Evans, Roy",1,Anfield
1996-12-02,1996,Tottenham Hotspur,Liverpool,0-2,0,2,1,1,2,-2,A,"Evans, Roy",2,Away
1996-12-07,1996,Liverpool,Sheffield Wednesday,0-1,0,1,1,1,1,-1,A,"Evans, Roy",0,Anfield
1996-12-14,1996,Liverpool,Middlesbrough,5-1,5,1,1,1,6,4,H,"Evans, Roy",5,Anfield
1996-12-17,1996,Liverpool,Nottingham Forest,4-2,4,2,1,1,6,2,H,"Evans, Roy",4,Anfield
1996-12-23,1996,Newcastle United,Liverpool,1-1,1,1,1,1,2,0,D,"Evans, Roy",1,Away
1996-12-26,1996,Liverpool,Leicester City,1-1,1,1,1,1,2,0,D,"Evans, Roy",1,Anfield
1996-12-29,1996,Southampton,Liverpool,0-1,0,1,1,1,1,-1,A,"Evans, Roy",1,Away
1997-01-01,1996,Chelsea,Liverpool,1-0,1,0,1,1,1,1,H,"Evans, Roy",0,Away
1997-01-11,1996,Liverpool,West Ham United,0-0,0,0,1,1,0,0,D,"Evans, Roy",0,Anfield
1997-01-18,1996,Liverpool,Aston Villa,3-0,3,0,1,1,3,3,H,"Evans, Roy",3,Anfield
1997-02-01,1996,Derby County,Liverpool,0-1,0,1,1,1,1,-1,A,"Evans, Roy",1,Away
1997-02-19,1996,Liverpool,Leeds United,4-0,4,0,1,1,4,4,H,"Evans, Roy",4,Anfield
1997-02-22,1996,Liverpool,Blackburn Rovers,0-0,0,0,1,1,0,0,D,"Evans, Roy",0,Anfield
1997-03-02,1996,Aston Villa,Liverpool,1-0,1,0,1,1,1,1,H,"Evans, Roy",0,Away
1997-03-10,1996,Liverpool,Newcastle United,4-3,4,3,1,1,7,1,H,"Evans, Roy",4,Anfield
1997-03-15,1996,Nottingham Forest,Liverpool,1-1,1,1,1,1,2,0,D,"Evans, Roy",1,Away
1997-03-24,1996,Arsenal,Liverpool,1-2,1,2,1,1,3,-1,A,"Evans, Roy",2,Away
1997-04-06,1996,Liverpool,Coventry City,1-2,1,2,1,1,3,-1,A,"Evans, Roy",1,Anfield
1997-04-13,1996,Sunderland,Liverpool,1-2,1,2,1,1,3,-1,A,"Evans, Roy",2,Away
1997-04-16,1996,Everton,Liverpool,1-1,1,1,1,1,2,0,D,"Evans, Roy",1,Away
1997-04-19,1996,Liverpool,Manchester United,1-3,1,3,1,1,4,-2,A,"Evans, Roy",1,Anfield
1997-05-03,1996,Liverpool,Tottenham Hotspur,2-1,2,1,1,1,3,1,H,"Evans, Roy",2,Anfield
1997-05-06,1996,Wimbledon,Liverpool,2-1,2,1,1,1,3,1,H,"Evans, Roy",1,Away
1997-05-11,1996,Sheffield Wednesday,Liverpool,1-1,1,1,1,1,2,0,D,"Evans, Roy",1,Away
1997-08-09,1997,Wimbledon,Liverpool,1-1,1,1,1,1,2,0,D,"Evans, Roy",1,Away
1997-08-13,1997,Liverpool,Leicester City,1-2,1,2,1,1,3,-1,A,"Evans, Roy",1,Anfield
1997-08-23,1997,Blackburn Rovers,Liverpool,1-1,1,1,1,1,2,0,D,"Evans, Roy",1,Away
1997-08-26,1997,Leeds United,Liverpool,0-2,0,2,1,1,2,-2,A,"Evans, Roy",2,Away
1997-09-13,1997,Liverpool,Sheffield Wednesday,2-1,2,1,1,1,3,1,H,"Evans, Roy",2,Anfield
1997-09-20,1997,Southampton,Liverpool,1-1,1,1,1,1,2,0,D,"Evans, Roy",1,Away
1997-09-22,1997,Liverpool,Aston Villa,3-0,3,0,1,1,3,3,H,"Evans, Roy",3,Anfield
1997-09-27,1997,West Ham United,Liverpool,2-1,2,1,1,1,3,1,H,"Evans, Roy",1,Away
1997-10-05,1997,Liverpool,Chelsea,4-2,4,2,1,1,6,2,H,"Evans, Roy",4,Anfield
1997-10-18,1997,Everton,Liverpool,2-0,2,0,1,1,2,2,H,"Evans, Roy",0,Away
1997-10-25,1997,Liverpool,Derby County,4-0,4,0,1,1,4,4,H,"Evans, Roy",4,Anfield
1997-11-01,1997,Bolton Wanderers,Liverpool,1-1,1,1,1,1,2,0,D,"Evans, Roy",1,Away
1997-11-08,1997,Liverpool,Tottenham Hotspur,4-0,4,0,1,1,4,4,H,"Evans, Roy",4,Anfield
1997-11-22,1997,Liverpool,Barnsley,0-1,0,1,1,1,1,-1,A,"Evans, Roy",0,Anfield
1997-11-30,1997,Arsenal,Liverpool,0-1,0,1,1,1,1,-1,A,"Evans, Roy",1,Away
1997-12-06,1997,Liverpool,Manchester United,1-3,1,3,1,1,4,-2,A,"Evans, Roy",1,Anfield
1997-12-13,1997,Crystal Palace,Liverpool,0-3,0,3,1,1,3,-3,A,"Evans, Roy",3,Away
1997-12-20,1997,Liverpool,Coventry City,1-0,1,0,1,1,1,1,H,"Evans, Roy",1,Anfield
1997-12-26,1997,Liverpool,Leeds United,3-1,3,1,1,1,4,2,H,"Evans, Roy",3,Anfield
1997-12-28,1997,Newcastle United,Liverpool,1-2,1,2,1,1,3,-1,A,"Evans, Roy",2,Away
1998-01-10,1997,Liverpool,Wimbledon,2-0,2,0,1,1,2,2,H,"Evans, Roy",2,Anfield
1998-01-17,1997,Leicester City,Liverpool,0-0,0,0,1,1,0,0,D,"Evans, Roy",0,Away
1998-01-20,1997,Liverpool,Newcastle United,1-0,1,0,1,1,1,1,H,"Evans, Roy",1,Anfield
1998-01-31,1997,Liverpool,Blackburn Rovers,0-0,0,0,1,1,0,0,D,"Evans, Roy",0,Anfield
1998-02-07,1997,Liverpool,Southampton,2-3,2,3,1,1,5,-1,A,"Evans, Roy",2,Anfield
1998-02-14,1997,Sheffield Wednesday,Liverpool,3-3,3,3,1,1,6,0,D,"Evans, Roy",3,Away
1998-02-23,1997,Liverpool,Everton,1-1,1,1,1,1,2,0,D,"Evans, Roy",1,Anfield
1998-02-28,1997,Aston Villa,Liverpool,2-1,2,1,1,1,3,1,H,"Evans, Roy",1,Away
1998-03-07,1997,Liverpool,Bolton Wanderers,2-1,2,1,1,1,3,1,H,"Evans, Roy",2,Anfield
1998-03-14,1997,Tottenham Hotspur,Liverpool,3-3,3,3,1,1,6,0,D,"Evans, Roy",3,Away
1998-03-28,1997,Barnsley,Liverpool,2-3,2,3,1,1,5,-1,A,"Evans, Roy",3,Away
1998-04-10,1997,Manchester United,Liverpool,1-1,1,1,1,1,2,0,D,"Evans, Roy",1,Away
1998-04-13,1997,Liverpool,Crystal Palace,2-1,2,1,1,1,3,1,H,"Evans, Roy",2,Anfield
1998-04-19,1997,Coventry City,Liverpool,1-1,1,1,1,1,2,0,D,"Evans, Roy",1,Away
1998-04-25,1997,Chelsea,Liverpool,4-1,4,1,1,1,5,3,H,"Evans, Roy",1,Away
1998-05-02,1997,Liverpool,West Ham United,5-0,5,0,1,1,5,5,H,"Evans, Roy",5,Anfield
1998-05-06,1997,Liverpool,Arsenal,4-0,4,0,1,1,4,4,H,"Evans, Roy",4,Anfield
1998-05-10,1997,Derby County,Liverpool,1-0,1,0,1,1,1,1,H,"Evans, Roy",0,Away
1998-08-16,1998,Southampton,Liverpool,1-2,1,2,1,1,3,-1,A,"Houllier, Gérard",2,Away
1998-08-22,1998,Liverpool,Arsenal,0-0,0,0,1,1,0,0,D,"Houllier, Gérard",0,Anfield
1998-08-30,1998,Newcastle United,Liverpool,1-4,1,4,1,1,5,-3,A,"Houllier, Gérard",4,Away
1998-09-09,1998,Liverpool,Coventry City,2-0,2,0,1,1,2,2,H,"Houllier, Gérard",2,Anfield
1998-09-12,1998,West Ham United,Liverpool,2-1,2,1,1,1,3,1,H,"Houllier, Gérard",1,Away
1998-09-19,1998,Liverpool,Charlton Athletic,3-3,3,3,1,1,6,0,D,"Houllier, Gérard",3,Anfield
1998-09-24,1998,Manchester United,Liverpool,2-0,2,0,1,1,2,2,H,"Houllier, Gérard",0,Away
1998-10-04,1998,Liverpool,Chelsea,1-1,1,1,1,1,2,0,D,"Houllier, Gérard",1,Anfield
1998-10-17,1998,Everton,Liverpool,0-0,0,0,1,1,0,0,D,"Houllier, Gérard",0,Away
1998-10-24,1998,Liverpool,Nottingham Forest,5-1,5,1,1,1,6,4,H,"Houllier, Gérard",5,Anfield
1998-10-31,1998,Leicester City,Liverpool,1-0,1,0,1,1,1,1,H,"Houllier, Gérard",0,Away
1998-11-07,1998,Liverpool,Derby County,1-2,1,2,1,1,3,-1,A,"Houllier, Gérard",1,Anfield
1998-11-14,1998,Liverpool,Leeds United,1-3,1,3,1,1,4,-2,A,"Houllier, Gérard",1,Anfield
1998-11-21,1998,Aston Villa,Liverpool,2-4,2,4,1,1,6,-2,A,"Houllier, Gérard",4,Away
1998-11-29,1998,Liverpool,Blackburn Rovers,2-0,2,0,1,1,2,2,H,"Houllier, Gérard",2,Anfield
1998-12-05,1998,Tottenham Hotspur,Liverpool,2-1,2,1,1,1,3,1,H,"Houllier, Gérard",1,Away
1998-12-13,1998,Wimbledon,Liverpool,1-0,1,0,1,1,1,1,H,"Houllier, Gérard",0,Away
1998-12-19,1998,Liverpool,Sheffield Wednesday,2-0,2,0,1,1,2,2,H,"Houllier, Gérard",2,Anfield
1998-12-26,1998,Middlesbrough,Liverpool,1-3,1,3,1,1,4,-2,A,"Houllier, Gérard",3,Away
1998-12-28,1998,Liverpool,Newcastle United,4-2,4,2,1,1,6,2,H,"Houllier, Gérard",4,Anfield
1999-01-09,1998,Arsenal,Liverpool,0-0,0,0,1,1,0,0,D,"Houllier, Gérard",0,Away
1999-01-16,1998,Liverpool,Southampton,7-1,7,1,1,1,8,6,H,"Houllier, Gérard",7,Anfield
1999-01-30,1998,Coventry City,Liverpool,2-1,2,1,1,1,3,1,H,"Houllier, Gérard",1,Away
1999-02-06,1998,Liverpool,Middlesbrough,3-1,3,1,1,1,4,2,H,"Houllier, Gérard",3,Anfield
1999-02-13,1998,Charlton Athletic,Liverpool,1-0,1,0,1,1,1,1,H,"Houllier, Gérard",0,Away
1999-02-20,1998,Liverpool,West Ham United,2-2,2,2,1,1,4,0,D,"Houllier, Gérard",2,Anfield
1999-02-27,1998,Chelsea,Liverpool,2-1,2,1,1,1,3,1,H,"Houllier, Gérard",1,Away
1999-03-13,1998,Derby County,Liverpool,3-2,3,2,1,1,5,1,H,"Houllier, Gérard",2,Away
1999-04-03,1998,Liverpool,Everton,3-2,3,2,1,1,5,1,H,"Houllier, Gérard",3,Anfield
1999-04-05,1998,Nottingham Forest,Liverpool,2-2,2,2,1,1,4,0,D,"Houllier, Gérard",2,Away
1999-04-12,1998,Leeds United,Liverpool,0-0,0,0,1,1,0,0,D,"Houllier, Gérard",0,Away
1999-04-17,1998,Liverpool,Aston Villa,0-1,0,1,1,1,1,-1,A,"Houllier, Gérard",0,Anfield
1999-04-21,1998,Liverpool,Leicester City,0-1,0,1,1,1,1,-1,A,"Houllier, Gérard",0,Anfield
1999-04-24,1998,Blackburn Rovers,Liverpool,1-3,1,3,1,1,4,-2,A,"Houllier, Gérard",3,Away
1999-05-01,1998,Liverpool,Tottenham Hotspur,3-2,3,2,1,1,5,1,H,"Houllier, Gérard",3,Anfield
1999-05-05,1998,Liverpool,Manchester United,2-2,2,2,1,1,4,0,D,"Houllier, Gérard",2,Anfield
1999-05-08,1998,Sheffield Wednesday,Liverpool,1-0,1,0,1,1,1,1,H,"Houllier, Gérard",0,Away
1999-05-16,1998,Liverpool,Wimbledon,3-0,3,0,1,1,3,3,H,"Houllier, Gérard",3,Anfield
1999-08-07,1999,Sheffield Wednesday,Liverpool,1-2,1,2,1,1,3,-1,A,"Houllier, Gérard",2,Away
1999-08-14,1999,Liverpool,Watford,0-1,0,1,1,1,1,-1,A,"Houllier, Gérard",0,Anfield
1999-08-21,1999,Middlesbrough,Liverpool,1-0,1,0,1,1,1,1,H,"Houllier, Gérard",0,Away
1999-08-23,1999,Leeds United,Liverpool,1-2,1,2,1,1,3,-1,A,"Houllier, Gérard",2,Away
1999-08-28,1999,Liverpool,Arsenal,2-0,2,0,1,1,2,2,H,"Houllier, Gérard",2,Anfield
1999-09-11,1999,Liverpool,Manchester United,2-3,2,3,1,1,5,-1,A,"Houllier, Gérard",2,Anfield
1999-09-18,1999,Leicester City,Liverpool,2-2,2,2,1,1,4,0,D,"Houllier, Gérard",2,Away
1999-09-27,1999,Liverpool,Everton,0-1,0,1,1,1,1,-1,A,"Houllier, Gérard",0,Anfield
1999-10-02,1999,Aston Villa,Liverpool,0-0,0,0,1,1,0,0,D,"Houllier, Gérard",0,Away
1999-10-16,1999,Liverpool,Chelsea,1-0,1,0,1,1,1,1,H,"Houllier, Gérard",1,Anfield
1999-10-23,1999,Southampton,Liverpool,1-1,1,1,1,1,2,0,D,"Houllier, Gérard",1,Away
1999-10-27,1999,Liverpool,West Ham United,1-0,1,0,1,1,1,1,H,"Houllier, Gérard",1,Anfield
1999-11-01,1999,Liverpool,Bradford City,3-1,3,1,1,1,4,2,H,"Houllier, Gérard",3,Anfield
1999-11-06,1999,Liverpool,Derby County,2-0,2,0,1,1,2,2,H,"Houllier, Gérard",2,Anfield
1999-11-20,1999,Sunderland,Liverpool,0-2,0,2,1,1,2,-2,A,"Houllier, Gérard",2,Away
1999-11-27,1999,West Ham United,Liverpool,1-0,1,0,1,1,1,1,H,"Houllier, Gérard",0,Away
1999-12-05,1999,Liverpool,Sheffield Wednesday,4-1,4,1,1,1,5,3,H,"Houllier, Gérard",4,Anfield
1999-12-18,1999,Liverpool,Coventry City,2-0,2,0,1,1,2,2,H,"Houllier, Gérard",2,Anfield
1999-12-26,1999,Newcastle United,Liverpool,2-2,2,2,1,1,4,0,D,"Houllier, Gérard",2,Away
1999-12-28,1999,Liverpool,Wimbledon,3-1,3,1,1,1,4,2,H,"Houllier, Gérard",3,Anfield
2000-01-03,1999,Tottenham Hotspur,Liverpool,1-0,1,0,1,1,1,1,H,"Houllier, Gérard",0,Away
2000-01-15,1999,Watford,Liverpool,2-3,2,3,1,1,5,-1,A,"Houllier, Gérard",3,Away
2000-01-22,1999,Liverpool,Middlesbrough,0-0,0,0,1,1,0,0,D,"Houllier, Gérard",0,Anfield
2000-02-05,1999,Liverpool,Leeds United,3-1,3,1,1,1,4,2,H,"Houllier, Gérard",3,Anfield
2000-02-13,1999,Arsenal,Liverpool,0-1,0,1,1,1,1,-1,A,"Houllier, Gérard",1,Away
2000-03-04,1999,Manchester United,Liverpool,1-1,1,1,1,1,2,0,D,"Houllier, Gérard",1,Away
2000-03-11,1999,Liverpool,Sunderland,1-1,1,1,1,1,2,0,D,"Houllier, Gérard",1,Anfield
2000-03-15,1999,Liverpool,Aston Villa,0-0,0,0,1,1,0,0,D,"Houllier, Gérard",0,Anfield
2000-03-18,1999,Derby County,Liverpool,0-2,0,2,1,1,2,-2,A,"Houllier, Gérard",2,Away
2000-03-25,1999,Liverpool,Newcastle United,2-1,2,1,1,1,3,1,H,"Houllier, Gérard",2,Anfield
2000-04-01,1999,Coventry City,Liverpool,0-3,0,3,1,1,3,-3,A,"Houllier, Gérard",3,Away
2000-04-09,1999,Liverpool,Tottenham Hotspur,2-0,2,0,1,1,2,2,H,"Houllier, Gérard",2,Anfield
2000-04-16,1999,Wimbledon,Liverpool,1-2,1,2,1,1,3,-1,A,"Houllier, Gérard",2,Away
2000-04-21,1999,Everton,Liverpool,0-0,0,0,1,1,0,0,D,"Houllier, Gérard",0,Away
2000-04-29,1999,Chelsea,Liverpool,2-0,2,0,1,1,2,2,H,"Houllier, Gérard",0,Away
2000-05-03,1999,Liverpool,Leicester City,0-2,0,2,1,1,2,-2,A,"Houllier, Gérard",0,Anfield
2000-05-07,1999,Liverpool,Southampton,0-0,0,0,1,1,0,0,D,"Houllier, Gérard",0,Anfield
2000-05-14,1999,Bradford City,Liverpool,1-0,1,0,1,1,1,1,H,"Houllier, Gérard",0,Away
2000-08-19,2e3,Liverpool,Bradford City,1-0,1,0,1,1,1,1,H,"Houllier, Gérard",1,Anfield
2000-08-21,2e3,Arsenal,Liverpool,2-0,2,0,1,1,2,2,H,"Houllier, Gérard",0,Away
2000-08-26,2e3,Southampton,Liverpool,3-3,3,3,1,1,6,0,D,"Houllier, Gérard",3,Away
2000-09-06,2e3,Liverpool,Aston Villa,3-1,3,1,1,1,4,2,H,"Houllier, Gérard",3,Anfield
2000-09-09,2e3,Liverpool,Manchester City,3-2,3,2,1,1,5,1,H,"Houllier, Gérard",3,Anfield
2000-09-17,2e3,West Ham United,Liverpool,1-1,1,1,1,1,2,0,D,"Houllier, Gérard",1,Away
2000-09-23,2e3,Liverpool,Sunderland,1-1,1,1,1,1,2,0,D,"Houllier, Gérard",1,Anfield
2000-10-01,2e3,Chelsea,Liverpool,3-0,3,0,1,1,3,3,H,"Houllier, Gérard",0,Away
2000-10-15,2e3,Derby County,Liverpool,0-4,0,4,1,1,4,-4,A,"Houllier, Gérard",4,Away
2000-10-21,2e3,Liverpool,Leicester City,1-0,1,0,1,1,1,1,H,"Houllier, Gérard",1,Anfield
2000-10-29,2e3,Liverpool,Everton,3-1,3,1,1,1,4,2,H,"Houllier, Gérard",3,Anfield
2000-11-04,2e3,Leeds United,Liverpool,4-3,4,3,1,1,7,1,H,"Houllier, Gérard",3,Away
2000-11-12,2e3,Liverpool,Coventry City,4-1,4,1,1,1,5,3,H,"Houllier, Gérard",4,Anfield
2000-11-19,2e3,Tottenham Hotspur,Liverpool,2-1,2,1,1,1,3,1,H,"Houllier, Gérard",1,Away
2000-11-26,2e3,Newcastle United,Liverpool,2-1,2,1,1,1,3,1,H,"Houllier, Gérard",1,Away
2000-12-02,2e3,Liverpool,Charlton Athletic,3-0,3,0,1,1,3,3,H,"Houllier, Gérard",3,Anfield
2000-12-10,2e3,Liverpool,Ipswich Town,0-1,0,1,1,1,1,-1,A,"Houllier, Gérard",0,Anfield
2000-12-17,2e3,Manchester United,Liverpool,0-1,0,1,1,1,1,-1,A,"Houllier, Gérard",1,Away
2000-12-23,2e3,Liverpool,Arsenal,4-0,4,0,1,1,4,4,H,"Houllier, Gérard",4,Anfield
2000-12-26,2e3,Middlesbrough,Liverpool,1-0,1,0,1,1,1,1,H,"Houllier, Gérard",0,Away
2001-01-01,2e3,Liverpool,Southampton,2-1,2,1,1,1,3,1,H,"Houllier, Gérard",2,Anfield
2001-01-13,2e3,Aston Villa,Liverpool,0-3,0,3,1,1,3,-3,A,"Houllier, Gérard",3,Away
2001-01-20,2e3,Liverpool,Middlesbrough,0-0,0,0,1,1,0,0,D,"Houllier, Gérard",0,Anfield
2001-01-31,2e3,Manchester City,Liverpool,1-1,1,1,1,1,2,0,D,"Houllier, Gérard",1,Away
2001-02-03,2e3,Liverpool,West Ham United,3-0,3,0,1,1,3,3,H,"Houllier, Gérard",3,Anfield
2001-02-10,2e3,Sunderland,Liverpool,1-1,1,1,1,1,2,0,D,"Houllier, Gérard",1,Away
2001-03-03,2e3,Leicester City,Liverpool,2-0,2,0,1,1,2,2,H,"Houllier, Gérard",0,Away
2001-03-18,2e3,Liverpool,Derby County,1-1,1,1,1,1,2,0,D,"Houllier, Gérard",1,Anfield
2001-03-31,2e3,Liverpool,Manchester United,2-0,2,0,1,1,2,2,H,"Houllier, Gérard",2,Anfield
2001-04-10,2e3,Ipswich Town,Liverpool,1-1,1,1,1,1,2,0,D,"Houllier, Gérard",1,Away
2001-04-13,2e3,Liverpool,Leeds United,1-2,1,2,1,1,3,-1,A,"Houllier, Gérard",1,Anfield
2001-04-16,2e3,Everton,Liverpool,2-3,2,3,1,1,5,-1,A,"Houllier, Gérard",3,Away
2001-04-22,2e3,Liverpool,Tottenham Hotspur,3-1,3,1,1,1,4,2,H,"Houllier, Gérard",3,Anfield
2001-04-28,2e3,Coventry City,Liverpool,0-2,0,2,1,1,2,-2,A,"Houllier, Gérard",2,Away
2001-05-01,2e3,Bradford City,Liverpool,0-2,0,2,1,1,2,-2,A,"Houllier, Gérard",2,Away
2001-05-05,2e3,Liverpool,Newcastle United,3-0,3,0,1,1,3,3,H,"Houllier, Gérard",3,Anfield
2001-05-08,2e3,Liverpool,Chelsea,2-2,2,2,1,1,4,0,D,"Houllier, Gérard",2,Anfield
2001-05-19,2e3,Charlton Athletic,Liverpool,0-4,0,4,1,1,4,-4,A,"Houllier, Gérard",4,Away
2001-08-18,2001,Liverpool,West Ham United,2-1,2,1,1,1,3,1,H,"Houllier, Gérard",2,Anfield
2001-08-27,2001,Bolton Wanderers,Liverpool,2-1,2,1,1,1,3,1,H,"Houllier, Gérard",1,Away
2001-09-08,2001,Liverpool,Aston Villa,1-3,1,3,1,1,4,-2,A,"Houllier, Gérard",1,Anfield
2001-09-15,2001,Everton,Liverpool,1-3,1,3,1,1,4,-2,A,"Houllier, Gérard",3,Away
2001-09-22,2001,Liverpool,Tottenham Hotspur,1-0,1,0,1,1,1,1,H,"Houllier, Gérard",1,Anfield
2001-09-30,2001,Newcastle United,Liverpool,0-2,0,2,1,1,2,-2,A,"Houllier, Gérard",2,Away
2001-10-13,2001,Liverpool,Leeds United,1-1,1,1,1,1,2,0,D,"Houllier, Gérard",1,Anfield
2001-10-20,2001,Leicester City,Liverpool,1-4,1,4,1,1,5,-3,A,"Houllier, Gérard",4,Away
2001-10-27,2001,Charlton Athletic,Liverpool,0-2,0,2,1,1,2,-2,A,"Houllier, Gérard",2,Away
2001-11-04,2001,Liverpool,Manchester United,3-1,3,1,1,1,4,2,H,"Houllier, Gérard",3,Anfield
2001-11-17,2001,Blackburn Rovers,Liverpool,1-1,1,1,1,1,2,0,D,"Houllier, Gérard",1,Away
2001-11-25,2001,Liverpool,Sunderland,1-0,1,0,1,1,1,1,H,"Houllier, Gérard",1,Anfield
2001-12-01,2001,Derby County,Liverpool,0-1,0,1,1,1,1,-1,A,"Houllier, Gérard",1,Away
2001-12-08,2001,Liverpool,Middlesbrough,2-0,2,0,1,1,2,2,H,"Houllier, Gérard",2,Anfield
2001-12-12,2001,Liverpool,Fulham,0-0,0,0,1,1,0,0,D,"Houllier, Gérard",0,Anfield
2001-12-16,2001,Chelsea,Liverpool,4-0,4,0,1,1,4,4,H,"Houllier, Gérard",0,Away
2001-12-23,2001,Liverpool,Arsenal,1-2,1,2,1,1,3,-1,A,"Houllier, Gérard",1,Anfield
2001-12-26,2001,Aston Villa,Liverpool,1-2,1,2,1,1,3,-1,A,"Houllier, Gérard",2,Away
2001-12-29,2001,West Ham United,Liverpool,1-1,1,1,1,1,2,0,D,"Houllier, Gérard",1,Away
2002-01-01,2001,Liverpool,Bolton Wanderers,1-1,1,1,1,1,2,0,D,"Houllier, Gérard",1,Anfield
2002-01-09,2001,Southampton,Liverpool,2-0,2,0,1,1,2,2,H,"Houllier, Gérard",0,Away
2002-01-13,2001,Arsenal,Liverpool,1-1,1,1,1,1,2,0,D,"Houllier, Gérard",1,Away
2002-01-19,2001,Liverpool,Southampton,1-1,1,1,1,1,2,0,D,"Houllier, Gérard",1,Anfield
2002-01-22,2001,Manchester United,Liverpool,0-1,0,1,1,1,1,-1,A,"Houllier, Gérard",1,Away
2002-01-30,2001,Liverpool,Leicester City,1-0,1,0,1,1,1,1,H,"Houllier, Gérard",1,Anfield
2002-02-03,2001,Leeds United,Liverpool,0-4,0,4,1,1,4,-4,A,"Houllier, Gérard",4,Away
2002-02-09,2001,Ipswich Town,Liverpool,0-6,0,6,1,1,6,-6,A,"Houllier, Gérard",6,Away
2002-02-23,2001,Liverpool,Everton,1-1,1,1,1,1,2,0,D,"Houllier, Gérard",1,Anfield
2002-03-02,2001,Fulham,Liverpool,0-2,0,2,1,1,2,-2,A,"Houllier, Gérard",2,Away
2002-03-06,2001,Liverpool,Newcastle United,3-0,3,0,1,1,3,3,H,"Houllier, Gérard",3,Anfield
2002-03-16,2001,Middlesbrough,Liverpool,1-2,1,2,1,1,3,-1,A,"Houllier, Gérard",2,Away
2002-03-24,2001,Liverpool,Chelsea,1-0,1,0,1,1,1,1,H,"Houllier, Gérard",1,Anfield
2002-03-30,2001,Liverpool,Charlton Athletic,2-0,2,0,1,1,2,2,H,"Houllier, Gérard",2,Anfield
2002-04-13,2001,Sunderland,Liverpool,0-1,0,1,1,1,1,-1,A,"Houllier, Gérard",1,Away
2002-04-20,2001,Liverpool,Derby County,2-0,2,0,1,1,2,2,H,"Houllier, Gérard",2,Anfield
2002-04-27,2001,Tottenham Hotspur,Liverpool,1-0,1,0,1,1,1,1,H,"Houllier, Gérard",0,Away
2002-05-08,2001,Liverpool,Blackburn Rovers,4-3,4,3,1,1,7,1,H,"Houllier, Gérard",4,Anfield
2002-05-11,2001,Liverpool,Ipswich Town,5-0,5,0,1,1,5,5,H,"Houllier, Gérard",5,Anfield
2002-08-18,2002,Aston Villa,Liverpool,0-1,0,1,1,1,1,-1,A,"Houllier, Gérard",1,Away
2002-08-24,2002,Liverpool,Southampton,3-0,3,0,1,1,3,3,H,"Houllier, Gérard",3,Anfield
2002-08-28,2002,Blackburn Rovers,Liverpool,2-2,2,2,1,1,4,0,D,"Houllier, Gérard",2,Away
2002-09-02,2002,Liverpool,Newcastle United,2-2,2,2,1,1,4,0,D,"Houllier, Gérard",2,Anfield
2002-09-11,2002,Liverpool,Birmingham City,2-2,2,2,1,1,4,0,D,"Houllier, Gérard",2,Anfield
2002-09-14,2002,Bolton Wanderers,Liverpool,2-3,2,3,1,1,5,-1,A,"Houllier, Gérard",3,Away
2002-09-21,2002,Liverpool,West Bromwich Albion,2-0,2,0,1,1,2,2,H,"Houllier, Gérard",2,Anfield
2002-09-28,2002,Manchester City,Liverpool,0-3,0,3,1,1,3,-3,A,"Houllier, Gérard",3,Away
2002-10-06,2002,Liverpool,Chelsea,1-0,1,0,1,1,1,1,H,"Houllier, Gérard",1,Anfield
2002-10-19,2002,Leeds United,Liverpool,0-1,0,1,1,1,1,-1,A,"Houllier, Gérard",1,Away
2002-10-26,2002,Liverpool,Tottenham Hotspur,2-1,2,1,1,1,3,1,H,"Houllier, Gérard",2,Anfield
2002-11-02,2002,Liverpool,West Ham United,2-0,2,0,1,1,2,2,H,"Houllier, Gérard",2,Anfield
2002-11-09,2002,Middlesbrough,Liverpool,1-0,1,0,1,1,1,1,H,"Houllier, Gérard",0,Away
2002-11-17,2002,Liverpool,Sunderland,0-0,0,0,1,1,0,0,D,"Houllier, Gérard",0,Anfield
2002-11-23,2002,Fulham,Liverpool,3-2,3,2,1,1,5,1,H,"Houllier, Gérard",2,Away
2002-12-01,2002,Liverpool,Manchester United,1-2,1,2,1,1,3,-1,A,"Houllier, Gérard",1,Anfield
2002-12-07,2002,Charlton Athletic,Liverpool,2-0,2,0,1,1,2,2,H,"Houllier, Gérard",0,Away
2002-12-15,2002,Sunderland,Liverpool,2-1,2,1,1,1,3,1,H,"Houllier, Gérard",1,Away
2002-12-22,2002,Liverpool,Everton,0-0,0,0,1,1,0,0,D,"Houllier, Gérard",0,Anfield
2002-12-26,2002,Liverpool,Blackburn Rovers,1-1,1,1,1,1,2,0,D,"Houllier, Gérard",1,Anfield
2002-12-29,2002,Arsenal,Liverpool,1-1,1,1,1,1,2,0,D,"Houllier, Gérard",1,Away
2003-01-01,2002,Newcastle United,Liverpool,1-0,1,0,1,1,1,1,H,"Houllier, Gérard",0,Away
2003-01-11,2002,Liverpool,Aston Villa,1-1,1,1,1,1,2,0,D,"Houllier, Gérard",1,Anfield
2003-01-18,2002,Southampton,Liverpool,0-1,0,1,1,1,1,-1,A,"Houllier, Gérard",1,Away
2003-01-29,2002,Liverpool,Arsenal,2-2,2,2,1,1,4,0,D,"Houllier, Gérard",2,Anfield
2003-02-02,2002,West Ham United,Liverpool,0-3,0,3,1,1,3,-3,A,"Houllier, Gérard",3,Away
2003-02-08,2002,Liverpool,Middlesbrough,1-1,1,1,1,1,2,0,D,"Houllier, Gérard",1,Anfield
2003-02-23,2002,Birmingham City,Liverpool,2-1,2,1,1,1,3,1,H,"Houllier, Gérard",1,Away
2003-03-08,2002,Liverpool,Bolton Wanderers,2-0,2,0,1,1,2,2,H,"Houllier, Gérard",2,Anfield
2003-03-16,2002,Tottenham Hotspur,Liverpool,2-3,2,3,1,1,5,-1,A,"Houllier, Gérard",3,Away
2003-03-23,2002,Liverpool,Leeds United,3-1,3,1,1,1,4,2,H,"Houllier, Gérard",3,Anfield
2003-04-05,2002,Manchester United,Liverpool,4-0,4,0,1,1,4,4,H,"Houllier, Gérard",0,Away
2003-04-12,2002,Liverpool,Fulham,2-0,2,0,1,1,2,2,H,"Houllier, Gérard",2,Anfield
2003-04-19,2002,Everton,Liverpool,1-2,1,2,1,1,3,-1,A,"Houllier, Gérard",2,Away
2003-04-21,2002,Liverpool,Charlton Athletic,2-1,2,1,1,1,3,1,H,"Houllier, Gérard",2,Anfield
2003-04-26,2002,West Bromwich Albion,Liverpool,0-6,0,6,1,1,6,-6,A,"Houllier, Gérard",6,Away
2003-05-03,2002,Liverpool,Manchester City,1-2,1,2,1,1,3,-1,A,"Houllier, Gérard",1,Anfield
2003-05-11,2002,Chelsea,Liverpool,2-1,2,1,1,1,3,1,H,"Houllier, Gérard",1,Away
2003-08-17,2003,Liverpool,Chelsea,1-2,1,2,1,1,3,-1,A,"Houllier, Gérard",1,Anfield
2003-08-24,2003,Aston Villa,Liverpool,0-0,0,0,1,1,0,0,D,"Houllier, Gérard",0,Away
2003-08-27,2003,Liverpool,Tottenham Hotspur,0-0,0,0,1,1,0,0,D,"Houllier, Gérard",0,Anfield
2003-08-30,2003,Everton,Liverpool,0-3,0,3,1,1,3,-3,A,"Houllier, Gérard",3,Away
2003-09-13,2003,Blackburn Rovers,Liverpool,1-3,1,3,1,1,4,-2,A,"Houllier, Gérard",3,Away
2003-09-20,2003,Liverpool,Leicester City,2-1,2,1,1,1,3,1,H,"Houllier, Gérard",2,Anfield
2003-09-28,2003,Charlton Athletic,Liverpool,3-2,3,2,1,1,5,1,H,"Houllier, Gérard",2,Away
2003-10-04,2003,Liverpool,Arsenal,1-2,1,2,1,1,3,-1,A,"Houllier, Gérard",1,Anfield
2003-10-18,2003,Portsmouth,Liverpool,1-0,1,0,1,1,1,1,H,"Houllier, Gérard",0,Away
2003-10-25,2003,Liverpool,Leeds United,3-1,3,1,1,1,4,2,H,"Houllier, Gérard",3,Anfield
2003-11-02,2003,Fulham,Liverpool,1-2,1,2,1,1,3,-1,A,"Houllier, Gérard",2,Away
2003-11-09,2003,Liverpool,Manchester United,1-2,1,2,1,1,3,-1,A,"Houllier, Gérard",1,Anfield
2003-11-22,2003,Middlesbrough,Liverpool,0-0,0,0,1,1,0,0,D,"Houllier, Gérard",0,Away
2003-11-30,2003,Liverpool,Birmingham City,3-1,3,1,1,1,4,2,H,"Houllier, Gérard",3,Anfield
2003-12-06,2003,Newcastle United,Liverpool,1-1,1,1,1,1,2,0,D,"Houllier, Gérard",1,Away
2003-12-13,2003,Liverpool,Southampton,1-2,1,2,1,1,3,-1,A,"Houllier, Gérard",1,Anfield
2003-12-26,2003,Liverpool,Bolton Wanderers,3-1,3,1,1,1,4,2,H,"Houllier, Gérard",3,Anfield
2003-12-28,2003,Manchester City,Liverpool,2-2,2,2,1,1,4,0,D,"Houllier, Gérard",2,Away
2004-01-07,2003,Chelsea,Liverpool,0-1,0,1,1,1,1,-1,A,"Houllier, Gérard",1,Away
2004-01-10,2003,Liverpool,Aston Villa,1-0,1,0,1,1,1,1,H,"Houllier, Gérard",1,Anfield
2004-01-17,2003,Tottenham Hotspur,Liverpool,2-1,2,1,1,1,3,1,H,"Houllier, Gérard",1,Away
2004-01-21,2003,Wolverhampton Wanderers,Liverpool,1-1,1,1,1,1,2,0,D,"Houllier, Gérard",1,Away
2004-01-31,2003,Liverpool,Everton,0-0,0,0,1,1,0,0,D,"Houllier, Gérard",0,Anfield
2004-02-07,2003,Bolton Wanderers,Liverpool,2-2,2,2,1,1,4,0,D,"Houllier, Gérard",2,Away
2004-02-11,2003,Liverpool,Manchester City,2-1,2,1,1,1,3,1,H,"Houllier, Gérard",2,Anfield
2004-02-29,2003,Leeds United,Liverpool,2-2,2,2,1,1,4,0,D,"Houllier, Gérard",2,Away
2004-03-14,2003,Southampton,Liverpool,2-0,2,0,1,1,2,2,H,"Houllier, Gérard",0,Away
2004-03-17,2003,Liverpool,Portsmouth,3-0,3,0,1,1,3,3,H,"Houllier, Gérard",3,Anfield
2004-03-20,2003,Liverpool,Wolverhampton Wanderers,1-0,1,0,1,1,1,1,H,"Houllier, Gérard",1,Anfield
2004-03-28,2003,Leicester City,Liverpool,0-0,0,0,1,1,0,0,D,"Houllier, Gérard",0,Away
2004-04-04,2003,Liverpool,Blackburn Rovers,4-0,4,0,1,1,4,4,H,"Houllier, Gérard",4,Anfield
2004-04-09,2003,Arsenal,Liverpool,4-2,4,2,1,1,6,2,H,"Houllier, Gérard",2,Away
2004-04-12,2003,Liverpool,Charlton Athletic,0-1,0,1,1,1,1,-1,A,"Houllier, Gérard",0,Anfield
2004-04-17,2003,Liverpool,Fulham,0-0,0,0,1,1,0,0,D,"Houllier, Gérard",0,Anfield
2004-04-24,2003,Manchester United,Liverpool,0-1,0,1,1,1,1,-1,A,"Houllier, Gérard",1,Away
2004-05-02,2003,Liverpool,Middlesbrough,2-0,2,0,1,1,2,2,H,"Houllier, Gérard",2,Anfield
2004-05-08,2003,Birmingham City,Liverpool,0-3,0,3,1,1,3,-3,A,"Houllier, Gérard",3,Away
2004-05-15,2003,Liverpool,Newcastle United,1-1,1,1,1,1,2,0,D,"Houllier, Gérard",1,Anfield
2004-08-14,2004,Tottenham Hotspur,Liverpool,1-1,1,1,1,1,2,0,D,"Benítez, Rafael",1,Away
2004-08-21,2004,Liverpool,Manchester City,2-1,2,1,1,1,3,1,H,"Benítez, Rafael",2,Anfield
2004-08-29,2004,Bolton Wanderers,Liverpool,1-0,1,0,1,1,1,1,H,"Benítez, Rafael",0,Away
2004-09-11,2004,Liverpool,West Bromwich Albion,3-0,3,0,1,1,3,3,H,"Benítez, Rafael",3,Anfield
2004-09-20,2004,Manchester United,Liverpool,2-1,2,1,1,1,3,1,H,"Benítez, Rafael",1,Away
2004-09-25,2004,Liverpool,Norwich City,3-0,3,0,1,1,3,3,H,"Benítez, Rafael",3,Anfield
2004-10-03,2004,Chelsea,Liverpool,1-0,1,0,1,1,1,1,H,"Benítez, Rafael",0,Away
2004-10-16,2004,Fulham,Liverpool,2-4,2,4,1,1,6,-2,A,"Benítez, Rafael",4,Away
2004-10-23,2004,Liverpool,Charlton Athletic,2-0,2,0,1,1,2,2,H,"Benítez, Rafael",2,Anfield
2004-10-30,2004,Blackburn Rovers,Liverpool,2-2,2,2,1,1,4,0,D,"Benítez, Rafael",2,Away
2004-11-06,2004,Liverpool,Birmingham City,0-1,0,1,1,1,1,-1,A,"Benítez, Rafael",0,Anfield
2004-11-13,2004,Liverpool,Crystal Palace,3-2,3,2,1,1,5,1,H,"Benítez, Rafael",3,Anfield
2004-11-20,2004,Middlesbrough,Liverpool,2-0,2,0,1,1,2,2,H,"Benítez, Rafael",0,Away
2004-11-28,2004,Liverpool,Arsenal,2-1,2,1,1,1,3,1,H,"Benítez, Rafael",2,Anfield
2004-12-04,2004,Aston Villa,Liverpool,1-1,1,1,1,1,2,0,D,"Benítez, Rafael",1,Away
2004-12-11,2004,Everton,Liverpool,1-0,1,0,1,1,1,1,H,"Benítez, Rafael",0,Away
2004-12-14,2004,Liverpool,Portsmouth,1-1,1,1,1,1,2,0,D,"Benítez, Rafael",1,Anfield
2004-12-19,2004,Liverpool,Newcastle United,3-1,3,1,1,1,4,2,H,"Benítez, Rafael",3,Anfield
2004-12-26,2004,West Bromwich Albion,Liverpool,0-5,0,5,1,1,5,-5,A,"Benítez, Rafael",5,Away
2004-12-28,2004,Liverpool,Southampton,1-0,1,0,1,1,1,1,H,"Benítez, Rafael",1,Anfield
2005-01-01,2004,Liverpool,Chelsea,0-1,0,1,1,1,1,-1,A,"Benítez, Rafael",0,Anfield
2005-01-03,2004,Norwich City,Liverpool,1-2,1,2,1,1,3,-1,A,"Benítez, Rafael",2,Away
2005-01-15,2004,Liverpool,Manchester United,0-1,0,1,1,1,1,-1,A,"Benítez, Rafael",0,Anfield
2005-01-22,2004,Southampton,Liverpool,2-0,2,0,1,1,2,2,H,"Benítez, Rafael",0,Away
2005-02-01,2004,Charlton Athletic,Liverpool,1-2,1,2,1,1,3,-1,A,"Benítez, Rafael",2,Away
2005-02-05,2004,Liverpool,Fulham,3-1,3,1,1,1,4,2,H,"Benítez, Rafael",3,Anfield
2005-02-12,2004,Birmingham City,Liverpool,2-0,2,0,1,1,2,2,H,"Benítez, Rafael",0,Away
2005-03-05,2004,Newcastle United,Liverpool,1-0,1,0,1,1,1,1,H,"Benítez, Rafael",0,Away
2005-03-16,2004,Liverpool,Blackburn Rovers,0-0,0,0,1,1,0,0,D,"Benítez, Rafael",0,Anfield
2005-03-20,2004,Liverpool,Everton,2-1,2,1,1,1,3,1,H,"Benítez, Rafael",2,Anfield
2005-04-02,2004,Liverpool,Bolton Wanderers,1-0,1,0,1,1,1,1,H,"Benítez, Rafael",1,Anfield
2005-04-09,2004,Manchester City,Liverpool,1-0,1,0,1,1,1,1,H,"Benítez, Rafael",0,Away
2005-04-16,2004,Liverpool,Tottenham Hotspur,2-2,2,2,1,1,4,0,D,"Benítez, Rafael",2,Anfield
2005-04-20,2004,Portsmouth,Liverpool,1-2,1,2,1,1,3,-1,A,"Benítez, Rafael",2,Away
2005-04-23,2004,Crystal Palace,Liverpool,1-0,1,0,1,1,1,1,H,"Benítez, Rafael",0,Away
2005-04-30,2004,Liverpool,Middlesbrough,1-1,1,1,1,1,2,0,D,"Benítez, Rafael",1,Anfield
2005-05-08,2004,Arsenal,Liverpool,3-1,3,1,1,1,4,2,H,"Benítez, Rafael",1,Away
2005-05-15,2004,Liverpool,Aston Villa,2-1,2,1,1,1,3,1,H,"Benítez, Rafael",2,Anfield
2005-08-13,2005,Middlesbrough,Liverpool,0-0,0,0,1,1,0,0,D,"Benítez, Rafael",0,Away
2005-08-20,2005,Liverpool,Sunderland,1-0,1,0,1,1,1,1,H,"Benítez, Rafael",1,Anfield
2005-09-10,2005,Tottenham Hotspur,Liverpool,0-0,0,0,1,1,0,0,D,"Benítez, Rafael",0,Away
2005-09-18,2005,Liverpool,Manchester United,0-0,0,0,1,1,0,0,D,"Benítez, Rafael",0,Anfield
2005-09-24,2005,Birmingham City,Liverpool,2-2,2,2,1,1,4,0,D,"Benítez, Rafael",2,Away
2005-10-02,2005,Liverpool,Chelsea,1-4,1,4,1,1,5,-3,A,"Benítez, Rafael",1,Anfield
2005-10-15,2005,Liverpool,Blackburn Rovers,1-0,1,0,1,1,1,1,H,"Benítez, Rafael",1,Anfield
2005-10-22,2005,Fulham,Liverpool,2-0,2,0,1,1,2,2,H,"Benítez, Rafael",0,Away
2005-10-29,2005,Liverpool,West Ham United,2-0,2,0,1,1,2,2,H,"Benítez, Rafael",2,Anfield
2005-11-05,2005,Aston Villa,Liverpool,0-2,0,2,1,1,2,-2,A,"Benítez, Rafael",2,Away
2005-11-19,2005,Liverpool,Portsmouth,3-0,3,0,1,1,3,3,H,"Benítez, Rafael",3,Anfield
2005-11-26,2005,Manchester City,Liverpool,0-1,0,1,1,1,1,-1,A,"Benítez, Rafael",1,Away
2005-11-30,2005,Sunderland,Liverpool,0-2,0,2,1,1,2,-2,A,"Benítez, Rafael",2,Away
2005-12-03,2005,Liverpool,Wigan Athletic,3-0,3,0,1,1,3,3,H,"Benítez, Rafael",3,Anfield
2005-12-10,2005,Liverpool,Middlesbrough,2-0,2,0,1,1,2,2,H,"Benítez, Rafael",2,Anfield
2005-12-26,2005,Liverpool,Newcastle United,2-0,2,0,1,1,2,2,H,"Benítez, Rafael",2,Anfield
2005-12-28,2005,Everton,Liverpool,1-3,1,3,1,1,4,-2,A,"Benítez, Rafael",3,Away
2005-12-31,2005,Liverpool,West Bromwich Albion,1-0,1,0,1,1,1,1,H,"Benítez, Rafael",1,Anfield
2006-01-02,2005,Bolton Wanderers,Liverpool,2-2,2,2,1,1,4,0,D,"Benítez, Rafael",2,Away
2006-01-14,2005,Liverpool,Tottenham Hotspur,1-0,1,0,1,1,1,1,H,"Benítez, Rafael",1,Anfield
2006-01-22,2005,Manchester United,Liverpool,1-0,1,0,1,1,1,1,H,"Benítez, Rafael",0,Away
2006-02-01,2005,Liverpool,Birmingham City,1-1,1,1,1,1,2,0,D,"Benítez, Rafael",1,Anfield
2006-02-05,2005,Chelsea,Liverpool,2-0,2,0,1,1,2,2,H,"Benítez, Rafael",0,Away
2006-02-08,2005,Charlton Athletic,Liverpool,2-0,2,0,1,1,2,2,H,"Benítez, Rafael",0,Away
2006-02-11,2005,Wigan Athletic,Liverpool,0-1,0,1,1,1,1,-1,A,"Benítez, Rafael",1,Away
2006-02-14,2005,Liverpool,Arsenal,1-0,1,0,1,1,1,1,H,"Benítez, Rafael",1,Anfield
2006-02-26,2005,Liverpool,Manchester City,1-0,1,0,1,1,1,1,H,"Benítez, Rafael",1,Anfield
2006-03-04,2005,Liverpool,Charlton Athletic,0-0,0,0,1,1,0,0,D,"Benítez, Rafael",0,Anfield
2006-03-12,2005,Arsenal,Liverpool,2-1,2,1,1,1,3,1,H,"Benítez, Rafael",1,Away
2006-03-15,2005,Liverpool,Fulham,5-1,5,1,1,1,6,4,H,"Benítez, Rafael",5,Anfield
2006-03-19,2005,Newcastle United,Liverpool,1-3,1,3,1,1,4,-2,A,"Benítez, Rafael",3,Away
2006-03-25,2005,Liverpool,Everton,3-1,3,1,1,1,4,2,H,"Benítez, Rafael",3,Anfield
2006-04-01,2005,West Bromwich Albion,Liverpool,0-2,0,2,1,1,2,-2,A,"Benítez, Rafael",2,Away
2006-04-09,2005,Liverpool,Bolton Wanderers,1-0,1,0,1,1,1,1,H,"Benítez, Rafael",1,Anfield
2006-04-16,2005,Blackburn Rovers,Liverpool,0-1,0,1,1,1,1,-1,A,"Benítez, Rafael",1,Away
2006-04-26,2005,West Ham United,Liverpool,1-2,1,2,1,1,3,-1,A,"Benítez, Rafael",2,Away
2006-04-29,2005,Liverpool,Aston Villa,3-1,3,1,1,1,4,2,H,"Benítez, Rafael",3,Anfield
2006-05-07,2005,Portsmouth,Liverpool,1-3,1,3,1,1,4,-2,A,"Benítez, Rafael",3,Away
2006-08-19,2006,Sheffield United,Liverpool,1-1,1,1,1,1,2,0,D,"Benítez, Rafael",1,Away
2006-08-26,2006,Liverpool,West Ham United,2-1,2,1,1,1,3,1,H,"Benítez, Rafael",2,Anfield
2006-09-09,2006,Everton,Liverpool,3-0,3,0,1,1,3,3,H,"Benítez, Rafael",0,Away
2006-09-17,2006,Chelsea,Liverpool,1-0,1,0,1,1,1,1,H,"Benítez, Rafael",0,Away
2006-09-20,2006,Liverpool,Newcastle United,2-0,2,0,1,1,2,2,H,"Benítez, Rafael",2,Anfield
2006-09-23,2006,Liverpool,Tottenham Hotspur,3-0,3,0,1,1,3,3,H,"Benítez, Rafael",3,Anfield
2006-09-30,2006,Bolton Wanderers,Liverpool,2-0,2,0,1,1,2,2,H,"Benítez, Rafael",0,Away
2006-10-14,2006,Liverpool,Blackburn Rovers,1-1,1,1,1,1,2,0,D,"Benítez, Rafael",1,Anfield
2006-10-22,2006,Manchester United,Liverpool,2-0,2,0,1,1,2,2,H,"Benítez, Rafael",0,Away
2006-10-28,2006,Liverpool,Aston Villa,3-1,3,1,1,1,4,2,H,"Benítez, Rafael",3,Anfield
2006-11-04,2006,Liverpool,Reading,2-0,2,0,1,1,2,2,H,"Benítez, Rafael",2,Anfield
2006-11-12,2006,Arsenal,Liverpool,3-0,3,0,1,1,3,3,H,"Benítez, Rafael",0,Away
2006-11-18,2006,Middlesbrough,Liverpool,0-0,0,0,1,1,0,0,D,"Benítez, Rafael",0,Away
2006-11-25,2006,Liverpool,Manchester City,1-0,1,0,1,1,1,1,H,"Benítez, Rafael",1,Anfield
2006-11-29,2006,Liverpool,Portsmouth,0-0,0,0,1,1,0,0,D,"Benítez, Rafael",0,Anfield
2006-12-02,2006,Wigan Athletic,Liverpool,0-4,0,4,1,1,4,-4,A,"Benítez, Rafael",4,Away
2006-12-09,2006,Liverpool,Fulham,4-0,4,0,1,1,4,4,H,"Benítez, Rafael",4,Anfield
2006-12-16,2006,Charlton Athletic,Liverpool,0-3,0,3,1,1,3,-3,A,"Benítez, Rafael",3,Away
2006-12-23,2006,Liverpool,Watford,2-0,2,0,1,1,2,2,H,"Benítez, Rafael",2,Anfield
2006-12-26,2006,Blackburn Rovers,Liverpool,1-0,1,0,1,1,1,1,H,"Benítez, Rafael",0,Away
2006-12-30,2006,Tottenham Hotspur,Liverpool,0-1,0,1,1,1,1,-1,A,"Benítez, Rafael",1,Away
2007-01-01,2006,Liverpool,Bolton Wanderers,3-0,3,0,1,1,3,3,H,"Benítez, Rafael",3,Anfield
2007-01-13,2006,Watford,Liverpool,0-3,0,3,1,1,3,-3,A,"Benítez, Rafael",3,Away
2007-01-20,2006,Liverpool,Chelsea,2-0,2,0,1,1,2,2,H,"Benítez, Rafael",2,Anfield
2007-01-30,2006,West Ham United,Liverpool,1-2,1,2,1,1,3,-1,A,"Benítez, Rafael",2,Away
2007-02-03,2006,Liverpool,Everton,0-0,0,0,1,1,0,0,D,"Benítez, Rafael",0,Anfield
2007-02-10,2006,Newcastle United,Liverpool,2-1,2,1,1,1,3,1,H,"Benítez, Rafael",1,Away
2007-02-24,2006,Liverpool,Sheffield United,4-0,4,0,1,1,4,4,H,"Benítez, Rafael",4,Anfield
2007-03-03,2006,Liverpool,Manchester United,0-1,0,1,1,1,1,-1,A,"Benítez, Rafael",0,Anfield
2007-03-18,2006,Aston Villa,Liverpool,0-0,0,0,1,1,0,0,D,"Benítez, Rafael",0,Away
2007-03-31,2006,Liverpool,Arsenal,4-1,4,1,1,1,5,3,H,"Benítez, Rafael",4,Anfield
2007-04-07,2006,Reading,Liverpool,1-2,1,2,1,1,3,-1,A,"Benítez, Rafael",2,Away
2007-04-14,2006,Manchester City,Liverpool,0-0,0,0,1,1,0,0,D,"Benítez, Rafael",0,Away
2007-04-18,2006,Liverpool,Middlesbrough,2-0,2,0,1,1,2,2,H,"Benítez, Rafael",2,Anfield
2007-04-21,2006,Liverpool,Wigan Athletic,2-0,2,0,1,1,2,2,H,"Benítez, Rafael",2,Anfield
2007-04-28,2006,Portsmouth,Liverpool,2-1,2,1,1,1,3,1,H,"Benítez, Rafael",1,Away
2007-05-05,2006,Fulham,Liverpool,1-0,1,0,1,1,1,1,H,"Benítez, Rafael",0,Away
2007-05-13,2006,Liverpool,Charlton Athletic,2-2,2,2,1,1,4,0,D,"Benítez, Rafael",2,Anfield
2007-08-11,2007,Aston Villa,Liverpool,1-2,1,2,1,1,3,-1,A,"Benítez, Rafael",2,Away
2007-08-19,2007,Liverpool,Chelsea,1-1,1,1,1,1,2,0,D,"Benítez, Rafael",1,Anfield
2007-08-25,2007,Sunderland,Liverpool,0-2,0,2,1,1,2,-2,A,"Benítez, Rafael",2,Away
2007-09-01,2007,Liverpool,Derby County,6-0,6,0,1,1,6,6,H,"Benítez, Rafael",6,Anfield
2007-09-15,2007,Portsmouth,Liverpool,0-0,0,0,1,1,0,0,D,"Benítez, Rafael",0,Away
2007-09-22,2007,Liverpool,Birmingham City,0-0,0,0,1,1,0,0,D,"Benítez, Rafael",0,Anfield
2007-09-29,2007,Wigan Athletic,Liverpool,0-1,0,1,1,1,1,-1,A,"Benítez, Rafael",1,Away
2007-10-07,2007,Liverpool,Tottenham Hotspur,2-2,2,2,1,1,4,0,D,"Benítez, Rafael",2,Anfield
2007-10-20,2007,Everton,Liverpool,1-2,1,2,1,1,3,-1,A,"Benítez, Rafael",2,Away
2007-10-28,2007,Liverpool,Arsenal,1-1,1,1,1,1,2,0,D,"Benítez, Rafael",1,Anfield
2007-11-03,2007,Blackburn Rovers,Liverpool,0-0,0,0,1,1,0,0,D,"Benítez, Rafael",0,Away
2007-11-10,2007,Liverpool,Fulham,2-0,2,0,1,1,2,2,H,"Benítez, Rafael",2,Anfield
2007-11-24,2007,Newcastle United,Liverpool,0-3,0,3,1,1,3,-3,A,"Benítez, Rafael",3,Away
2007-12-02,2007,Liverpool,Bolton Wanderers,4-0,4,0,1,1,4,4,H,"Benítez, Rafael",4,Anfield
2007-12-08,2007,Reading,Liverpool,3-1,3,1,1,1,4,2,H,"Benítez, Rafael",1,Away
2007-12-16,2007,Liverpool,Manchester United,0-1,0,1,1,1,1,-1,A,"Benítez, Rafael",0,Anfield
2007-12-22,2007,Liverpool,Portsmouth,4-1,4,1,1,1,5,3,H,"Benítez, Rafael",4,Anfield
2007-12-26,2007,Derby County,Liverpool,1-2,1,2,1,1,3,-1,A,"Benítez, Rafael",2,Away
2007-12-30,2007,Manchester City,Liverpool,0-0,0,0,1,1,0,0,D,"Benítez, Rafael",0,Away
2008-01-02,2007,Liverpool,Wigan Athletic,1-1,1,1,1,1,2,0,D,"Benítez, Rafael",1,Anfield
2008-01-12,2007,Middlesbrough,Liverpool,1-1,1,1,1,1,2,0,D,"Benítez, Rafael",1,Away
2008-01-21,2007,Liverpool,Aston Villa,2-2,2,2,1,1,4,0,D,"Benítez, Rafael",2,Anfield
2008-01-30,2007,West Ham United,Liverpool,1-0,1,0,1,1,1,1,H,"Benítez, Rafael",0,Away
2008-02-02,2007,Liverpool,Sunderland,3-0,3,0,1,1,3,3,H,"Benítez, Rafael",3,Anfield
2008-02-10,2007,Chelsea,Liverpool,0-0,0,0,1,1,0,0,D,"Benítez, Rafael",0,Away
2008-02-23,2007,Liverpool,Middlesbrough,3-2,3,2,1,1,5,1,H,"Benítez, Rafael",3,Anfield
2008-03-02,2007,Bolton Wanderers,Liverpool,1-3,1,3,1,1,4,-2,A,"Benítez, Rafael",3,Away
2008-03-05,2007,Liverpool,West Ham United,4-0,4,0,1,1,4,4,H,"Benítez, Rafael",4,Anfield
2008-03-08,2007,Liverpool,Newcastle United,3-0,3,0,1,1,3,3,H,"Benítez, Rafael",3,Anfield
2008-03-15,2007,Liverpool,Reading,2-1,2,1,1,1,3,1,H,"Benítez, Rafael",2,Anfield
2008-03-23,2007,Manchester United,Liverpool,3-0,3,0,1,1,3,3,H,"Benítez, Rafael",0,Away
2008-03-30,2007,Liverpool,Everton,1-0,1,0,1,1,1,1,H,"Benítez, Rafael",1,Anfield
2008-04-05,2007,Arsenal,Liverpool,1-1,1,1,1,1,2,0,D,"Benítez, Rafael",1,Away
2008-04-13,2007,Liverpool,Blackburn Rovers,3-1,3,1,1,1,4,2,H,"Benítez, Rafael",3,Anfield
2008-04-19,2007,Fulham,Liverpool,0-2,0,2,1,1,2,-2,A,"Benítez, Rafael",2,Away
2008-04-26,2007,Birmingham City,Liverpool,2-2,2,2,1,1,4,0,D,"Benítez, Rafael",2,Away
2008-05-04,2007,Liverpool,Manchester City,1-0,1,0,1,1,1,1,H,"Benítez, Rafael",1,Anfield
2008-05-11,2007,Tottenham Hotspur,Liverpool,0-2,0,2,1,1,2,-2,A,"Benítez, Rafael",2,Away
2008-08-16,2008,Sunderland,Liverpool,0-1,0,1,1,1,1,-1,A,"Benítez, Rafael",1,Away
2008-08-23,2008,Liverpool,Middlesbrough,2-1,2,1,1,1,3,1,H,"Benítez, Rafael",2,Anfield
2008-08-31,2008,Aston Villa,Liverpool,0-0,0,0,1,1,0,0,D,"Benítez, Rafael",0,Away
2008-09-13,2008,Liverpool,Manchester United,2-1,2,1,1,1,3,1,H,"Benítez, Rafael",2,Anfield
2008-09-20,2008,Liverpool,Stoke City,0-0,0,0,1,1,0,0,D,"Benítez, Rafael",0,Anfield
2008-09-27,2008,Everton,Liverpool,0-2,0,2,1,1,2,-2,A,"Benítez, Rafael",2,Away
2008-10-05,2008,Manchester City,Liverpool,2-3,2,3,1,1,5,-1,A,"Benítez, Rafael",3,Away
2008-10-18,2008,Liverpool,Wigan Athletic,3-2,3,2,1,1,5,1,H,"Benítez, Rafael",3,Anfield
2008-10-26,2008,Chelsea,Liverpool,0-1,0,1,1,1,1,-1,A,"Benítez, Rafael",1,Away
2008-10-29,2008,Liverpool,Portsmouth,1-0,1,0,1,1,1,1,H,"Benítez, Rafael",1,Anfield
2008-11-01,2008,Tottenham Hotspur,Liverpool,2-1,2,1,1,1,3,1,H,"Benítez, Rafael",1,Away
2008-11-08,2008,Liverpool,West Bromwich Albion,3-0,3,0,1,1,3,3,H,"Benítez, Rafael",3,Anfield
2008-11-15,2008,Bolton Wanderers,Liverpool,0-2,0,2,1,1,2,-2,A,"Benítez, Rafael",2,Away
2008-11-22,2008,Liverpool,Fulham,0-0,0,0,1,1,0,0,D,"Benítez, Rafael",0,Anfield
2008-12-01,2008,Liverpool,West Ham United,0-0,0,0,1,1,0,0,D,"Benítez, Rafael",0,Anfield
2008-12-06,2008,Blackburn Rovers,Liverpool,1-3,1,3,1,1,4,-2,A,"Benítez, Rafael",3,Away
2008-12-13,2008,Liverpool,Hull City,2-2,2,2,1,1,4,0,D,"Benítez, Rafael",2,Anfield
2008-12-21,2008,Arsenal,Liverpool,1-1,1,1,1,1,2,0,D,"Benítez, Rafael",1,Away
2008-12-26,2008,Liverpool,Bolton Wanderers,3-0,3,0,1,1,3,3,H,"Benítez, Rafael",3,Anfield
2008-12-28,2008,Newcastle United,Liverpool,1-5,1,5,1,1,6,-4,A,"Benítez, Rafael",5,Away
2009-01-10,2008,Stoke City,Liverpool,0-0,0,0,1,1,0,0,D,"Benítez, Rafael",0,Away
2009-01-19,2008,Liverpool,Everton,1-1,1,1,1,1,2,0,D,"Benítez, Rafael",1,Anfield
2009-01-28,2008,Wigan Athletic,Liverpool,1-1,1,1,1,1,2,0,D,"Benítez, Rafael",1,Away
2009-02-01,2008,Liverpool,Chelsea,2-0,2,0,1,1,2,2,H,"Benítez, Rafael",2,Anfield
2009-02-07,2008,Portsmouth,Liverpool,2-3,2,3,1,1,5,-1,A,"Benítez, Rafael",3,Away
2009-02-22,2008,Liverpool,Manchester City,1-1,1,1,1,1,2,0,D,"Benítez, Rafael",1,Anfield
2009-02-28,2008,Middlesbrough,Liverpool,2-0,2,0,1,1,2,2,H,"Benítez, Rafael",0,Away
2009-03-03,2008,Liverpool,Sunderland,2-0,2,0,1,1,2,2,H,"Benítez, Rafael",2,Anfield
2009-03-14,2008,Manchester United,Liverpool,1-4,1,4,1,1,5,-3,A,"Benítez, Rafael",4,Away
2009-03-22,2008,Liverpool,Aston Villa,5-0,5,0,1,1,5,5,H,"Benítez, Rafael",5,Anfield
2009-04-04,2008,Fulham,Liverpool,0-1,0,1,1,1,1,-1,A,"Benítez, Rafael",1,Away
2009-04-11,2008,Liverpool,Blackburn Rovers,4-0,4,0,1,1,4,4,H,"Benítez, Rafael",4,Anfield
2009-04-21,2008,Liverpool,Arsenal,4-4,4,4,1,1,8,0,D,"Benítez, Rafael",4,Anfield
2009-04-25,2008,Hull City,Liverpool,1-3,1,3,1,1,4,-2,A,"Benítez, Rafael",3,Away
2009-05-03,2008,Liverpool,Newcastle United,3-0,3,0,1,1,3,3,H,"Benítez, Rafael",3,Anfield
2009-05-09,2008,West Ham United,Liverpool,0-3,0,3,1,1,3,-3,A,"Benítez, Rafael",3,Away
2009-05-17,2008,West Bromwich Albion,Liverpool,0-2,0,2,1,1,2,-2,A,"Benítez, Rafael",2,Away
2009-05-24,2008,Liverpool,Tottenham Hotspur,3-1,3,1,1,1,4,2,H,"Benítez, Rafael",3,Anfield
2009-08-16,2009,Tottenham Hotspur,Liverpool,2-1,2,1,1,1,3,1,H,"Benítez, Rafael",1,Away
2009-08-19,2009,Liverpool,Stoke City,4-0,4,0,1,1,4,4,H,"Benítez, Rafael",4,Anfield
2009-08-24,2009,Liverpool,Aston Villa,1-3,1,3,1,1,4,-2,A,"Benítez, Rafael",1,Anfield
2009-08-29,2009,Bolton Wanderers,Liverpool,2-3,2,3,1,1,5,-1,A,"Benítez, Rafael",3,Away
2009-09-12,2009,Liverpool,Burnley,4-0,4,0,1,1,4,4,H,"Benítez, Rafael",4,Anfield
2009-09-19,2009,West Ham United,Liverpool,2-3,2,3,1,1,5,-1,A,"Benítez, Rafael",3,Away
2009-09-26,2009,Liverpool,Hull City,6-1,6,1,1,1,7,5,H,"Benítez, Rafael",6,Anfield
2009-10-04,2009,Chelsea,Liverpool,2-0,2,0,1,1,2,2,H,"Benítez, Rafael",0,Away
2009-10-17,2009,Sunderland,Liverpool,1-0,1,0,1,1,1,1,H,"Benítez, Rafael",0,Away
2009-10-25,2009,Liverpool,Manchester United,2-0,2,0,1,1,2,2,H,"Benítez, Rafael",2,Anfield
2009-10-31,2009,Fulham,Liverpool,3-1,3,1,1,1,4,2,H,"Benítez, Rafael",1,Away
2009-11-09,2009,Liverpool,Birmingham City,2-2,2,2,1,1,4,0,D,"Benítez, Rafael",2,Anfield
2009-11-21,2009,Liverpool,Manchester City,2-2,2,2,1,1,4,0,D,"Benítez, Rafael",2,Anfield
2009-11-29,2009,Everton,Liverpool,0-2,0,2,1,1,2,-2,A,"Benítez, Rafael",2,Away
2009-12-05,2009,Blackburn Rovers,Liverpool,0-0,0,0,1,1,0,0,D,"Benítez, Rafael",0,Away
2009-12-13,2009,Liverpool,Arsenal,1-2,1,2,1,1,3,-1,A,"Benítez, Rafael",1,Anfield
2009-12-16,2009,Liverpool,Wigan Athletic,2-1,2,1,1,1,3,1,H,"Benítez, Rafael",2,Anfield
2009-12-19,2009,Portsmouth,Liverpool,2-0,2,0,1,1,2,2,H,"Benítez, Rafael",0,Away
2009-12-26,2009,Liverpool,Wolverhampton Wanderers,2-0,2,0,1,1,2,2,H,"Benítez, Rafael",2,Anfield
2009-12-29,2009,Aston Villa,Liverpool,0-1,0,1,1,1,1,-1,A,"Benítez, Rafael",1,Away
2010-01-16,2009,Stoke City,Liverpool,1-1,1,1,1,1,2,0,D,"Benítez, Rafael",1,Away
2010-01-20,2009,Liverpool,Tottenham Hotspur,2-0,2,0,1,1,2,2,H,"Benítez, Rafael",2,Anfield
2010-01-26,2009,Wolverhampton Wanderers,Liverpool,0-0,0,0,1,1,0,0,D,"Benítez, Rafael",0,Away
2010-01-30,2009,Liverpool,Bolton Wanderers,2-0,2,0,1,1,2,2,H,"Benítez, Rafael",2,Anfield
2010-02-06,2009,Liverpool,Everton,1-0,1,0,1,1,1,1,H,"Benítez, Rafael",1,Anfield
2010-02-10,2009,Arsenal,Liverpool,1-0,1,0,1,1,1,1,H,"Benítez, Rafael",0,Away
2010-02-21,2009,Manchester City,Liverpool,0-0,0,0,1,1,0,0,D,"Benítez, Rafael",0,Away
2010-02-28,2009,Liverpool,Blackburn Rovers,2-1,2,1,1,1,3,1,H,"Benítez, Rafael",2,Anfield
2010-03-08,2009,Wigan Athletic,Liverpool,1-0,1,0,1,1,1,1,H,"Benítez, Rafael",0,Away
2010-03-15,2009,Liverpool,Portsmouth,4-1,4,1,1,1,5,3,H,"Benítez, Rafael",4,Anfield
2010-03-21,2009,Manchester United,Liverpool,2-1,2,1,1,1,3,1,H,"Benítez, Rafael",1,Away
2010-03-28,2009,Liverpool,Sunderland,3-0,3,0,1,1,3,3,H,"Benítez, Rafael",3,Anfield
2010-04-04,2009,Birmingham City,Liverpool,1-1,1,1,1,1,2,0,D,"Benítez, Rafael",1,Away
2010-04-11,2009,Liverpool,Fulham,0-0,0,0,1,1,0,0,D,"Benítez, Rafael",0,Anfield
2010-04-19,2009,Liverpool,West Ham United,3-0,3,0,1,1,3,3,H,"Benítez, Rafael",3,Anfield
2010-04-25,2009,Burnley,Liverpool,0-4,0,4,1,1,4,-4,A,"Benítez, Rafael",4,Away
2010-05-02,2009,Liverpool,Chelsea,0-2,0,2,1,1,2,-2,A,"Benítez, Rafael",0,Anfield
2010-05-09,2009,Hull City,Liverpool,0-0,0,0,1,1,0,0,D,"Benítez, Rafael",0,Away
2010-08-15,2010,Liverpool,Arsenal,1-1,1,1,1,1,2,0,D,"Hodgson, Roy",1,Anfield
2010-08-23,2010,Manchester City,Liverpool,3-0,3,0,1,1,3,3,H,"Hodgson, Roy",0,Away
2010-08-29,2010,Liverpool,West Bromwich Albion,1-0,1,0,1,1,1,1,H,"Hodgson, Roy",1,Anfield
2010-09-12,2010,Birmingham City,Liverpool,0-0,0,0,1,1,0,0,D,"Hodgson, Roy",0,Away
2010-09-19,2010,Manchester United,Liverpool,3-2,3,2,1,1,5,1,H,"Hodgson, Roy",2,Away
2010-09-25,2010,Liverpool,Sunderland,2-2,2,2,1,1,4,0,D,"Hodgson, Roy",2,Anfield
2010-10-03,2010,Liverpool,Blackpool,1-2,1,2,1,1,3,-1,A,"Hodgson, Roy",1,Anfield
2010-10-17,2010,Everton,Liverpool,2-0,2,0,1,1,2,2,H,"Hodgson, Roy",0,Away
2010-10-24,2010,Liverpool,Blackburn Rovers,2-1,2,1,1,1,3,1,H,"Hodgson, Roy",2,Anfield
2010-10-31,2010,Bolton Wanderers,Liverpool,0-1,0,1,1,1,1,-1,A,"Hodgson, Roy",1,Away
2010-11-07,2010,Liverpool,Chelsea,2-0,2,0,1,1,2,2,H,"Hodgson, Roy",2,Anfield
2010-11-10,2010,Wigan Athletic,Liverpool,1-1,1,1,1,1,2,0,D,"Hodgson, Roy",1,Away
2010-11-13,2010,Stoke City,Liverpool,2-0,2,0,1,1,2,2,H,"Hodgson, Roy",0,Away
2010-11-20,2010,Liverpool,West Ham United,3-0,3,0,1,1,3,3,H,"Hodgson, Roy",3,Anfield
2010-11-28,2010,Tottenham Hotspur,Liverpool,2-1,2,1,1,1,3,1,H,"Hodgson, Roy",1,Away
2010-12-06,2010,Liverpool,Aston Villa,3-0,3,0,1,1,3,3,H,"Hodgson, Roy",3,Anfield
2010-12-11,2010,Newcastle United,Liverpool,3-1,3,1,1,1,4,2,H,"Hodgson, Roy",1,Away
2010-12-29,2010,Liverpool,Wolverhampton Wanderers,0-1,0,1,1,1,1,-1,A,"Hodgson, Roy",0,Anfield
2011-01-01,2010,Liverpool,Bolton Wanderers,2-1,2,1,1,1,3,1,H,"Hodgson, Roy",2,Anfield
2011-01-05,2010,Blackburn Rovers,Liverpool,3-1,3,1,1,1,4,2,H,"Hodgson, Roy",1,Away
2011-01-12,2010,Blackpool,Liverpool,2-1,2,1,1,1,3,1,H,"Dalglish, Kenny",1,Away
2011-01-16,2010,Liverpool,Everton,2-2,2,2,1,1,4,0,D,"Dalglish, Kenny",2,Anfield
2011-01-22,2010,Wolverhampton Wanderers,Liverpool,0-3,0,3,1,1,3,-3,A,"Dalglish, Kenny",3,Away
2011-01-26,2010,Liverpool,Fulham,1-0,1,0,1,1,1,1,H,"Dalglish, Kenny",1,Anfield
2011-02-02,2010,Liverpool,Stoke City,2-0,2,0,1,1,2,2,H,"Dalglish, Kenny",2,Anfield
2011-02-06,2010,Chelsea,Liverpool,0-1,0,1,1,1,1,-1,A,"Dalglish, Kenny",1,Away
2011-02-12,2010,Liverpool,Wigan Athletic,1-1,1,1,1,1,2,0,D,"Dalglish, Kenny",1,Anfield
2011-02-27,2010,West Ham United,Liverpool,3-1,3,1,1,1,4,2,H,"Dalglish, Kenny",1,Away
2011-03-06,2010,Liverpool,Manchester United,3-1,3,1,1,1,4,2,H,"Dalglish, Kenny",3,Anfield
2011-03-20,2010,Sunderland,Liverpool,0-2,0,2,1,1,2,-2,A,"Dalglish, Kenny",2,Away
2011-04-02,2010,West Bromwich Albion,Liverpool,2-1,2,1,1,1,3,1,H,"Dalglish, Kenny",1,Away
2011-04-11,2010,Liverpool,Manchester City,3-0,3,0,1,1,3,3,H,"Dalglish, Kenny",3,Anfield
2011-04-17,2010,Arsenal,Liverpool,1-1,1,1,1,1,2,0,D,"Dalglish, Kenny",1,Away
2011-04-23,2010,Liverpool,Birmingham City,5-0,5,0,1,1,5,5,H,"Dalglish, Kenny",5,Anfield
2011-05-01,2010,Liverpool,Newcastle United,3-0,3,0,1,1,3,3,H,"Dalglish, Kenny",3,Anfield
2011-05-09,2010,Fulham,Liverpool,2-5,2,5,1,1,7,-3,A,"Dalglish, Kenny",5,Away
2011-05-15,2010,Liverpool,Tottenham Hotspur,0-2,0,2,1,1,2,-2,A,"Dalglish, Kenny",0,Anfield
2011-05-22,2010,Aston Villa,Liverpool,1-0,1,0,1,1,1,1,H,"Dalglish, Kenny",0,Away
2011-08-13,2011,Liverpool,Sunderland,1-1,1,1,1,1,2,0,D,"Dalglish, Kenny",1,Anfield
2011-08-20,2011,Arsenal,Liverpool,0-2,0,2,1,1,2,-2,A,"Dalglish, Kenny",2,Away
2011-08-27,2011,Liverpool,Bolton Wanderers,3-1,3,1,1,1,4,2,H,"Dalglish, Kenny",3,Anfield
2011-09-10,2011,Stoke City,Liverpool,1-0,1,0,1,1,1,1,H,"Dalglish, Kenny",0,Away
2011-09-18,2011,Tottenham Hotspur,Liverpool,4-0,4,0,1,1,4,4,H,"Dalglish, Kenny",0,Away
2011-09-24,2011,Liverpool,Wolverhampton Wanderers,2-1,2,1,1,1,3,1,H,"Dalglish, Kenny",2,Anfield
2011-10-01,2011,Everton,Liverpool,0-2,0,2,1,1,2,-2,A,"Dalglish, Kenny",2,Away
2011-10-15,2011,Liverpool,Manchester United,1-1,1,1,1,1,2,0,D,"Dalglish, Kenny",1,Anfield
2011-10-22,2011,Liverpool,Norwich City,1-1,1,1,1,1,2,0,D,"Dalglish, Kenny",1,Anfield
2011-10-29,2011,West Bromwich Albion,Liverpool,0-2,0,2,1,1,2,-2,A,"Dalglish, Kenny",2,Away
2011-11-05,2011,Liverpool,Swansea City,0-0,0,0,1,1,0,0,D,"Dalglish, Kenny",0,Anfield
2011-11-20,2011,Chelsea,Liverpool,1-2,1,2,1,1,3,-1,A,"Dalglish, Kenny",2,Away
2011-11-27,2011,Liverpool,Manchester City,1-1,1,1,1,1,2,0,D,"Dalglish, Kenny",1,Anfield
2011-12-05,2011,Fulham,Liverpool,1-0,1,0,1,1,1,1,H,"Dalglish, Kenny",0,Away
2011-12-10,2011,Liverpool,Queens Park Rangers,1-0,1,0,1,1,1,1,H,"Dalglish, Kenny",1,Anfield
2011-12-18,2011,Aston Villa,Liverpool,0-2,0,2,1,1,2,-2,A,"Dalglish, Kenny",2,Away
2011-12-21,2011,Wigan Athletic,Liverpool,0-0,0,0,1,1,0,0,D,"Dalglish, Kenny",0,Away
2011-12-26,2011,Liverpool,Blackburn Rovers,1-1,1,1,1,1,2,0,D,"Dalglish, Kenny",1,Anfield
2011-12-30,2011,Liverpool,Newcastle United,3-1,3,1,1,1,4,2,H,"Dalglish, Kenny",3,Anfield
2012-01-03,2011,Manchester City,Liverpool,3-0,3,0,1,1,3,3,H,"Dalglish, Kenny",0,Away
2012-01-14,2011,Liverpool,Stoke City,0-0,0,0,1,1,0,0,D,"Dalglish, Kenny",0,Anfield
2012-01-21,2011,Bolton Wanderers,Liverpool,3-1,3,1,1,1,4,2,H,"Dalglish, Kenny",1,Away
2012-01-31,2011,Wolverhampton Wanderers,Liverpool,0-3,0,3,1,1,3,-3,A,"Dalglish, Kenny",3,Away
2012-02-06,2011,Liverpool,Tottenham Hotspur,0-0,0,0,1,1,0,0,D,"Dalglish, Kenny",0,Anfield
2012-02-11,2011,Manchester United,Liverpool,2-1,2,1,1,1,3,1,H,"Dalglish, Kenny",1,Away
2012-03-03,2011,Liverpool,Arsenal,1-2,1,2,1,1,3,-1,A,"Dalglish, Kenny",1,Anfield
2012-03-10,2011,Sunderland,Liverpool,1-0,1,0,1,1,1,1,H,"Dalglish, Kenny",0,Away
2012-03-13,2011,Liverpool,Everton,3-0,3,0,1,1,3,3,H,"Dalglish, Kenny",3,Anfield
2012-03-21,2011,Queens Park Rangers,Liverpool,3-2,3,2,1,1,5,1,H,"Dalglish, Kenny",2,Away
2012-03-24,2011,Liverpool,Wigan Athletic,1-2,1,2,1,1,3,-1,A,"Dalglish, Kenny",1,Anfield
2012-04-01,2011,Newcastle United,Liverpool,2-0,2,0,1,1,2,2,H,"Dalglish, Kenny",0,Away
2012-04-07,2011,Liverpool,Aston Villa,1-1,1,1,1,1,2,0,D,"Dalglish, Kenny",1,Anfield
2012-04-10,2011,Blackburn Rovers,Liverpool,2-3,2,3,1,1,5,-1,A,"Dalglish, Kenny",3,Away
2012-04-22,2011,Liverpool,West Bromwich Albion,0-1,0,1,1,1,1,-1,A,"Dalglish, Kenny",0,Anfield
2012-04-28,2011,Norwich City,Liverpool,0-3,0,3,1,1,3,-3,A,"Dalglish, Kenny",3,Away
2012-05-01,2011,Liverpool,Fulham,0-1,0,1,1,1,1,-1,A,"Dalglish, Kenny",0,Anfield
2012-05-08,2011,Liverpool,Chelsea,4-1,4,1,1,1,5,3,H,"Dalglish, Kenny",4,Anfield
2012-05-13,2011,Swansea City,Liverpool,1-0,1,0,1,1,1,1,H,"Dalglish, Kenny",0,Away
2012-08-18,2012,West Bromwich Albion,Liverpool,3-0,3,0,1,1,3,3,H,"Rodgers, Brendan",0,Away
2012-08-26,2012,Liverpool,Manchester City,2-2,2,2,1,1,4,0,D,"Rodgers, Brendan",2,Anfield
2012-09-02,2012,Liverpool,Arsenal,0-2,0,2,1,1,2,-2,A,"Rodgers, Brendan",0,Anfield
2012-09-15,2012,Sunderland,Liverpool,1-1,1,1,1,1,2,0,D,"Rodgers, Brendan",1,Away
2012-09-23,2012,Liverpool,Manchester United,1-2,1,2,1,1,3,-1,A,"Rodgers, Brendan",1,Anfield
2012-09-29,2012,Norwich City,Liverpool,2-5,2,5,1,1,7,-3,A,"Rodgers, Brendan",5,Away
2012-10-07,2012,Liverpool,Stoke City,0-0,0,0,1,1,0,0,D,"Rodgers, Brendan",0,Anfield
2012-10-20,2012,Liverpool,Reading,1-0,1,0,1,1,1,1,H,"Rodgers, Brendan",1,Anfield
2012-10-28,2012,Everton,Liverpool,2-2,2,2,1,1,4,0,D,"Rodgers, Brendan",2,Away
2012-11-04,2012,Liverpool,Newcastle United,1-1,1,1,1,1,2,0,D,"Rodgers, Brendan",1,Anfield
2012-11-11,2012,Chelsea,Liverpool,1-1,1,1,1,1,2,0,D,"Rodgers, Brendan",1,Away
2012-11-17,2012,Liverpool,Wigan Athletic,3-0,3,0,1,1,3,3,H,"Rodgers, Brendan",3,Anfield
2012-11-25,2012,Swansea City,Liverpool,0-0,0,0,1,1,0,0,D,"Rodgers, Brendan",0,Away
2012-11-28,2012,Tottenham Hotspur,Liverpool,2-1,2,1,1,1,3,1,H,"Rodgers, Brendan",1,Away
2012-12-01,2012,Liverpool,Southampton,1-0,1,0,1,1,1,1,H,"Rodgers, Brendan",1,Anfield
2012-12-09,2012,West Ham United,Liverpool,2-3,2,3,1,1,5,-1,A,"Rodgers, Brendan",3,Away
2012-12-15,2012,Liverpool,Aston Villa,1-3,1,3,1,1,4,-2,A,"Rodgers, Brendan",1,Anfield
2012-12-22,2012,Liverpool,Fulham,4-0,4,0,1,1,4,4,H,"Rodgers, Brendan",4,Anfield
2012-12-26,2012,Stoke City,Liverpool,3-1,3,1,1,1,4,2,H,"Rodgers, Brendan",1,Away
2012-12-30,2012,Queens Park Rangers,Liverpool,0-3,0,3,1,1,3,-3,A,"Rodgers, Brendan",3,Away
2013-01-02,2012,Liverpool,Sunderland,3-0,3,0,1,1,3,3,H,"Rodgers, Brendan",3,Anfield
2013-01-13,2012,Manchester United,Liverpool,2-1,2,1,1,1,3,1,H,"Rodgers, Brendan",1,Away
2013-01-19,2012,Liverpool,Norwich City,5-0,5,0,1,1,5,5,H,"Rodgers, Brendan",5,Anfield
2013-01-30,2012,Arsenal,Liverpool,2-2,2,2,1,1,4,0,D,"Rodgers, Brendan",2,Away
2013-02-03,2012,Manchester City,Liverpool,2-2,2,2,1,1,4,0,D,"Rodgers, Brendan",2,Away
2013-02-11,2012,Liverpool,West Bromwich Albion,0-2,0,2,1,1,2,-2,A,"Rodgers, Brendan",0,Anfield
2013-02-17,2012,Liverpool,Swansea City,5-0,5,0,1,1,5,5,H,"Rodgers, Brendan",5,Anfield
2013-03-02,2012,Wigan Athletic,Liverpool,0-4,0,4,1,1,4,-4,A,"Rodgers, Brendan",4,Away
2013-03-10,2012,Liverpool,Tottenham Hotspur,3-2,3,2,1,1,5,1,H,"Rodgers, Brendan",3,Anfield
2013-03-16,2012,Southampton,Liverpool,3-1,3,1,1,1,4,2,H,"Rodgers, Brendan",1,Away
2013-03-31,2012,Aston Villa,Liverpool,1-2,1,2,1,1,3,-1,A,"Rodgers, Brendan",2,Away
2013-04-07,2012,Liverpool,West Ham United,0-0,0,0,1,1,0,0,D,"Rodgers, Brendan",0,Anfield
2013-04-13,2012,Reading,Liverpool,0-0,0,0,1,1,0,0,D,"Rodgers, Brendan",0,Away
2013-04-21,2012,Liverpool,Chelsea,2-2,2,2,1,1,4,0,D,"Rodgers, Brendan",2,Anfield
2013-04-27,2012,Newcastle United,Liverpool,0-6,0,6,1,1,6,-6,A,"Rodgers, Brendan",6,Away
2013-05-05,2012,Liverpool,Everton,0-0,0,0,1,1,0,0,D,"Rodgers, Brendan",0,Anfield
2013-05-12,2012,Fulham,Liverpool,1-3,1,3,1,1,4,-2,A,"Rodgers, Brendan",3,Away
2013-05-19,2012,Liverpool,Queens Park Rangers,1-0,1,0,1,1,1,1,H,"Rodgers, Brendan",1,Anfield
2013-08-17,2013,Liverpool,Stoke City,1-0,1,0,1,1,1,1,H,"Rodgers, Brendan",1,Anfield
2013-08-24,2013,Aston Villa,Liverpool,0-1,0,1,1,1,1,-1,A,"Rodgers, Brendan",1,Away
2013-09-01,2013,Liverpool,Manchester United,1-0,1,0,1,1,1,1,H,"Rodgers, Brendan",1,Anfield
2013-09-16,2013,Swansea City,Liverpool,2-2,2,2,1,1,4,0,D,"Rodgers, Brendan",2,Away
2013-09-21,2013,Liverpool,Southampton,0-1,0,1,1,1,1,-1,A,"Rodgers, Brendan",0,Anfield
2013-09-29,2013,Sunderland,Liverpool,1-3,1,3,1,1,4,-2,A,"Rodgers, Brendan",3,Away
2013-10-05,2013,Liverpool,Crystal Palace,3-1,3,1,1,1,4,2,H,"Rodgers, Brendan",3,Anfield
2013-10-19,2013,Newcastle United,Liverpool,2-2,2,2,1,1,4,0,D,"Rodgers, Brendan",2,Away
2013-10-26,2013,Liverpool,West Bromwich Albion,4-1,4,1,1,1,5,3,H,"Rodgers, Brendan",4,Anfield
2013-11-02,2013,Arsenal,Liverpool,2-0,2,0,1,1,2,2,H,"Rodgers, Brendan",0,Away
2013-11-09,2013,Liverpool,Fulham,4-0,4,0,1,1,4,4,H,"Rodgers, Brendan",4,Anfield
2013-11-23,2013,Everton,Liverpool,3-3,3,3,1,1,6,0,D,"Rodgers, Brendan",3,Away
2013-12-01,2013,Hull City,Liverpool,3-1,3,1,1,1,4,2,H,"Rodgers, Brendan",1,Away
2013-12-04,2013,Liverpool,Norwich City,5-1,5,1,1,1,6,4,H,"Rodgers, Brendan",5,Anfield
2013-12-07,2013,Liverpool,West Ham United,4-1,4,1,1,1,5,3,H,"Rodgers, Brendan",4,Anfield
2013-12-15,2013,Tottenham Hotspur,Liverpool,0-5,0,5,1,1,5,-5,A,"Rodgers, Brendan",5,Away
2013-12-21,2013,Liverpool,Cardiff City,3-1,3,1,1,1,4,2,H,"Rodgers, Brendan",3,Anfield
2013-12-26,2013,Manchester City,Liverpool,2-1,2,1,1,1,3,1,H,"Rodgers, Brendan",1,Away
2013-12-29,2013,Chelsea,Liverpool,2-1,2,1,1,1,3,1,H,"Rodgers, Brendan",1,Away
2014-01-01,2013,Liverpool,Hull City,2-0,2,0,1,1,2,2,H,"Rodgers, Brendan",2,Anfield
2014-01-12,2013,Stoke City,Liverpool,3-5,3,5,1,1,8,-2,A,"Rodgers, Brendan",5,Away
2014-01-18,2013,Liverpool,Aston Villa,2-2,2,2,1,1,4,0,D,"Rodgers, Brendan",2,Anfield
2014-01-28,2013,Liverpool,Everton,4-0,4,0,1,1,4,4,H,"Rodgers, Brendan",4,Anfield
2014-02-02,2013,West Bromwich Albion,Liverpool,1-1,1,1,1,1,2,0,D,"Rodgers, Brendan",1,Away
2014-02-08,2013,Liverpool,Arsenal,5-1,5,1,1,1,6,4,H,"Rodgers, Brendan",5,Anfield
2014-02-12,2013,Fulham,Liverpool,2-3,2,3,1,1,5,-1,A,"Rodgers, Brendan",3,Away
2014-02-23,2013,Liverpool,Swansea City,4-3,4,3,1,1,7,1,H,"Rodgers, Brendan",4,Anfield
2014-03-01,2013,Southampton,Liverpool,0-3,0,3,1,1,3,-3,A,"Rodgers, Brendan",3,Away
2014-03-16,2013,Manchester United,Liverpool,0-3,0,3,1,1,3,-3,A,"Rodgers, Brendan",3,Away
2014-03-22,2013,Cardiff City,Liverpool,3-6,3,6,1,1,9,-3,A,"Rodgers, Brendan",6,Away
2014-03-26,2013,Liverpool,Sunderland,2-1,2,1,1,1,3,1,H,"Rodgers, Brendan",2,Anfield
2014-03-30,2013,Liverpool,Tottenham Hotspur,4-0,4,0,1,1,4,4,H,"Rodgers, Brendan",4,Anfield
2014-04-06,2013,West Ham United,Liverpool,1-2,1,2,1,1,3,-1,A,"Rodgers, Brendan",2,Away
2014-04-13,2013,Liverpool,Manchester City,3-2,3,2,1,1,5,1,H,"Rodgers, Brendan",3,Anfield
2014-04-20,2013,Norwich City,Liverpool,2-3,2,3,1,1,5,-1,A,"Rodgers, Brendan",3,Away
2014-04-27,2013,Liverpool,Chelsea,0-2,0,2,1,1,2,-2,A,"Rodgers, Brendan",0,Anfield
2014-05-05,2013,Crystal Palace,Liverpool,3-3,3,3,1,1,6,0,D,"Rodgers, Brendan",3,Away
2014-05-11,2013,Liverpool,Newcastle United,2-1,2,1,1,1,3,1,H,"Rodgers, Brendan",2,Anfield
2014-08-17,2014,Liverpool,Southampton,2-1,2,1,1,1,3,1,H,"Rodgers, Brendan",2,Anfield
2014-08-25,2014,Manchester City,Liverpool,3-1,3,1,1,1,4,2,H,"Rodgers, Brendan",1,Away
2014-08-31,2014,Tottenham Hotspur,Liverpool,0-3,0,3,1,1,3,-3,A,"Rodgers, Brendan",3,Away
2014-09-13,2014,Liverpool,Aston Villa,0-1,0,1,1,1,1,-1,A,"Rodgers, Brendan",0,Anfield
2014-09-20,2014,West Ham United,Liverpool,3-1,3,1,1,1,4,2,H,"Rodgers, Brendan",1,Away
2014-09-27,2014,Liverpool,Everton,1-1,1,1,1,1,2,0,D,"Rodgers, Brendan",1,Anfield
2014-10-04,2014,Liverpool,West Bromwich Albion,2-1,2,1,1,1,3,1,H,"Rodgers, Brendan",2,Anfield
2014-10-19,2014,Queens Park Rangers,Liverpool,2-3,2,3,1,1,5,-1,A,"Rodgers, Brendan",3,Away
2014-10-25,2014,Liverpool,Hull City,0-0,0,0,1,1,0,0,D,"Rodgers, Brendan",0,Anfield
2014-11-01,2014,Newcastle United,Liverpool,1-0,1,0,1,1,1,1,H,"Rodgers, Brendan",0,Away
2014-11-08,2014,Liverpool,Chelsea,1-2,1,2,1,1,3,-1,A,"Rodgers, Brendan",1,Anfield
2014-11-23,2014,Crystal Palace,Liverpool,3-1,3,1,1,1,4,2,H,"Rodgers, Brendan",1,Away
2014-11-29,2014,Liverpool,Stoke City,1-0,1,0,1,1,1,1,H,"Rodgers, Brendan",1,Anfield
2014-12-02,2014,Leicester City,Liverpool,1-3,1,3,1,1,4,-2,A,"Rodgers, Brendan",3,Away
2014-12-06,2014,Liverpool,Sunderland,0-0,0,0,1,1,0,0,D,"Rodgers, Brendan",0,Anfield
2014-12-14,2014,Manchester United,Liverpool,3-0,3,0,1,1,3,3,H,"Rodgers, Brendan",0,Away
2014-12-21,2014,Liverpool,Arsenal,2-2,2,2,1,1,4,0,D,"Rodgers, Brendan",2,Anfield
2014-12-26,2014,Burnley,Liverpool,0-1,0,1,1,1,1,-1,A,"Rodgers, Brendan",1,Away
2014-12-29,2014,Liverpool,Swansea City,4-1,4,1,1,1,5,3,H,"Rodgers, Brendan",4,Anfield
2015-01-01,2014,Liverpool,Leicester City,2-2,2,2,1,1,4,0,D,"Rodgers, Brendan",2,Anfield
2015-01-10,2014,Sunderland,Liverpool,0-1,0,1,1,1,1,-1,A,"Rodgers, Brendan",1,Away
2015-01-17,2014,Aston Villa,Liverpool,0-2,0,2,1,1,2,-2,A,"Rodgers, Brendan",2,Away
2015-01-31,2014,Liverpool,West Ham United,2-0,2,0,1,1,2,2,H,"Rodgers, Brendan",2,Anfield
2015-02-07,2014,Everton,Liverpool,0-0,0,0,1,1,0,0,D,"Rodgers, Brendan",0,Away
2015-02-10,2014,Liverpool,Tottenham Hotspur,3-2,3,2,1,1,5,1,H,"Rodgers, Brendan",3,Anfield
2015-02-22,2014,Southampton,Liverpool,0-2,0,2,1,1,2,-2,A,"Rodgers, Brendan",2,Away
2015-03-01,2014,Liverpool,Manchester City,2-1,2,1,1,1,3,1,H,"Rodgers, Brendan",2,Anfield
2015-03-04,2014,Liverpool,Burnley,2-0,2,0,1,1,2,2,H,"Rodgers, Brendan",2,Anfield
2015-03-16,2014,Swansea City,Liverpool,0-1,0,1,1,1,1,-1,A,"Rodgers, Brendan",1,Away
2015-03-22,2014,Liverpool,Manchester United,1-2,1,2,1,1,3,-1,A,"Rodgers, Brendan",1,Anfield
2015-04-04,2014,Arsenal,Liverpool,4-1,4,1,1,1,5,3,H,"Rodgers, Brendan",1,Away
2015-04-13,2014,Liverpool,Newcastle United,2-0,2,0,1,1,2,2,H,"Rodgers, Brendan",2,Anfield
2015-04-25,2014,West Bromwich Albion,Liverpool,0-0,0,0,1,1,0,0,D,"Rodgers, Brendan",0,Away
2015-04-28,2014,Hull City,Liverpool,1-0,1,0,1,1,1,1,H,"Rodgers, Brendan",0,Away
2015-05-02,2014,Liverpool,Queens Park Rangers,2-1,2,1,1,1,3,1,H,"Rodgers, Brendan",2,Anfield
2015-05-10,2014,Chelsea,Liverpool,1-1,1,1,1,1,2,0,D,"Rodgers, Brendan",1,Away
2015-05-16,2014,Liverpool,Crystal Palace,1-3,1,3,1,1,4,-2,A,"Rodgers, Brendan",1,Anfield
2015-05-24,2014,Stoke City,Liverpool,6-1,6,1,1,1,7,5,H,"Rodgers, Brendan",1,Away
2015-08-09,2015,Stoke City,Liverpool,0-1,0,1,1,1,1,-1,A,"Rodgers, Brendan",1,Away
2015-08-17,2015,Liverpool,AFC Bournemouth,1-0,1,0,1,1,1,1,H,"Rodgers, Brendan",1,Anfield
2015-08-24,2015,Arsenal,Liverpool,0-0,0,0,1,1,0,0,D,"Rodgers, Brendan",0,Away
2015-08-29,2015,Liverpool,West Ham United,0-3,0,3,1,1,3,-3,A,"Rodgers, Brendan",0,Anfield
2015-09-12,2015,Manchester United,Liverpool,3-1,3,1,1,1,4,2,H,"Rodgers, Brendan",1,Away
2015-09-20,2015,Liverpool,Norwich City,1-1,1,1,1,1,2,0,D,"Rodgers, Brendan",1,Anfield
2015-09-26,2015,Liverpool,Aston Villa,3-2,3,2,1,1,5,1,H,"Rodgers, Brendan",3,Anfield
2015-10-04,2015,Everton,Liverpool,1-1,1,1,1,1,2,0,D,"Rodgers, Brendan",1,Away
2015-10-17,2015,Tottenham Hotspur,Liverpool,0-0,0,0,1,1,0,0,D,"Klopp, Jürgen",0,Away
2015-10-25,2015,Liverpool,Southampton,1-1,1,1,1,1,2,0,D,"Klopp, Jürgen",1,Anfield
2015-10-31,2015,Chelsea,Liverpool,1-3,1,3,1,1,4,-2,A,"Klopp, Jürgen",3,Away
2015-11-08,2015,Liverpool,Crystal Palace,1-2,1,2,1,1,3,-1,A,"Klopp, Jürgen",1,Anfield
2015-11-21,2015,Manchester City,Liverpool,1-4,1,4,1,1,5,-3,A,"Klopp, Jürgen",4,Away
2015-11-29,2015,Liverpool,Swansea City,1-0,1,0,1,1,1,1,H,"Klopp, Jürgen",1,Anfield
2015-12-06,2015,Newcastle United,Liverpool,2-0,2,0,1,1,2,2,H,"Klopp, Jürgen",0,Away
2015-12-13,2015,Liverpool,West Bromwich Albion,2-2,2,2,1,1,4,0,D,"Klopp, Jürgen",2,Anfield
2015-12-20,2015,Watford,Liverpool,3-0,3,0,1,1,3,3,H,"Klopp, Jürgen",0,Away
2015-12-26,2015,Liverpool,Leicester City,1-0,1,0,1,1,1,1,H,"Klopp, Jürgen",1,Anfield
2015-12-30,2015,Sunderland,Liverpool,0-1,0,1,1,1,1,-1,A,"Klopp, Jürgen",1,Away
2016-01-02,2015,West Ham United,Liverpool,2-0,2,0,1,1,2,2,H,"Klopp, Jürgen",0,Away
2016-01-13,2015,Liverpool,Arsenal,3-3,3,3,1,1,6,0,D,"Klopp, Jürgen",3,Anfield
2016-01-17,2015,Liverpool,Manchester United,0-1,0,1,1,1,1,-1,A,"Klopp, Jürgen",0,Anfield
2016-01-23,2015,Norwich City,Liverpool,4-5,4,5,1,1,9,-1,A,"Klopp, Jürgen",5,Away
2016-02-02,2015,Leicester City,Liverpool,2-0,2,0,1,1,2,2,H,"Klopp, Jürgen",0,Away
2016-02-06,2015,Liverpool,Sunderland,2-2,2,2,1,1,4,0,D,"Klopp, Jürgen",2,Anfield
2016-02-14,2015,Aston Villa,Liverpool,0-6,0,6,1,1,6,-6,A,"Klopp, Jürgen",6,Away
2016-03-02,2015,Liverpool,Manchester City,3-0,3,0,1,1,3,3,H,"Klopp, Jürgen",3,Anfield
2016-03-06,2015,Crystal Palace,Liverpool,1-2,1,2,1,1,3,-1,A,"Klopp, Jürgen",2,Away
2016-03-20,2015,Southampton,Liverpool,3-2,3,2,1,1,5,1,H,"Klopp, Jürgen",2,Away
2016-04-02,2015,Liverpool,Tottenham Hotspur,1-1,1,1,1,1,2,0,D,"Klopp, Jürgen",1,Anfield
2016-04-10,2015,Liverpool,Stoke City,4-1,4,1,1,1,5,3,H,"Klopp, Jürgen",4,Anfield
2016-04-17,2015,AFC Bournemouth,Liverpool,1-2,1,2,1,1,3,-1,A,"Klopp, Jürgen",2,Away
2016-04-20,2015,Liverpool,Everton,4-0,4,0,1,1,4,4,H,"Klopp, Jürgen",4,Anfield
2016-04-23,2015,Liverpool,Newcastle United,2-2,2,2,1,1,4,0,D,"Klopp, Jürgen",2,Anfield
2016-05-01,2015,Swansea City,Liverpool,3-1,3,1,1,1,4,2,H,"Klopp, Jürgen",1,Away
2016-05-08,2015,Liverpool,Watford,2-0,2,0,1,1,2,2,H,"Klopp, Jürgen",2,Anfield
2016-05-11,2015,Liverpool,Chelsea,1-1,1,1,1,1,2,0,D,"Klopp, Jürgen",1,Anfield
2016-05-15,2015,West Bromwich Albion,Liverpool,1-1,1,1,1,1,2,0,D,"Klopp, Jürgen",1,Away
2016-08-14,2016,Arsenal,Liverpool,3-4,3,4,1,1,7,-1,A,"Klopp, Jürgen",4,Away
2016-08-20,2016,Burnley,Liverpool,2-0,2,0,1,1,2,2,H,"Klopp, Jürgen",0,Away
2016-08-27,2016,Tottenham Hotspur,Liverpool,1-1,1,1,1,1,2,0,D,"Klopp, Jürgen",1,Away
2016-09-10,2016,Liverpool,Leicester City,4-1,4,1,1,1,5,3,H,"Klopp, Jürgen",4,Anfield
2016-09-16,2016,Chelsea,Liverpool,1-2,1,2,1,1,3,-1,A,"Klopp, Jürgen",2,Away
2016-09-24,2016,Liverpool,Hull City,5-1,5,1,1,1,6,4,H,"Klopp, Jürgen",5,Anfield
2016-10-01,2016,Swansea City,Liverpool,1-2,1,2,1,1,3,-1,A,"Klopp, Jürgen",2,Away
2016-10-17,2016,Liverpool,Manchester United,0-0,0,0,1,1,0,0,D,"Klopp, Jürgen",0,Anfield
2016-10-22,2016,Liverpool,West Bromwich Albion,2-1,2,1,1,1,3,1,H,"Klopp, Jürgen",2,Anfield
2016-10-29,2016,Crystal Palace,Liverpool,2-4,2,4,1,1,6,-2,A,"Klopp, Jürgen",4,Away
2016-11-06,2016,Liverpool,Watford,6-1,6,1,1,1,7,5,H,"Klopp, Jürgen",6,Anfield
2016-11-19,2016,Southampton,Liverpool,0-0,0,0,1,1,0,0,D,"Klopp, Jürgen",0,Away
2016-11-26,2016,Liverpool,Sunderland,2-0,2,0,1,1,2,2,H,"Klopp, Jürgen",2,Anfield
2016-12-04,2016,AFC Bournemouth,Liverpool,4-3,4,3,1,1,7,1,H,"Klopp, Jürgen",3,Away
2016-12-11,2016,Liverpool,West Ham United,2-2,2,2,1,1,4,0,D,"Klopp, Jürgen",2,Anfield
2016-12-14,2016,Middlesbrough,Liverpool,0-3,0,3,1,1,3,-3,A,"Klopp, Jürgen",3,Away
2016-12-19,2016,Everton,Liverpool,0-1,0,1,1,1,1,-1,A,"Klopp, Jürgen",1,Away
2016-12-27,2016,Liverpool,Stoke City,4-1,4,1,1,1,5,3,H,"Klopp, Jürgen",4,Anfield
2016-12-31,2016,Liverpool,Manchester City,1-0,1,0,1,1,1,1,H,"Klopp, Jürgen",1,Anfield
2017-01-02,2016,Sunderland,Liverpool,2-2,2,2,1,1,4,0,D,"Klopp, Jürgen",2,Away
2017-01-15,2016,Manchester United,Liverpool,1-1,1,1,1,1,2,0,D,"Klopp, Jürgen",1,Away
2017-01-21,2016,Liverpool,Swansea City,2-3,2,3,1,1,5,-1,A,"Klopp, Jürgen",2,Anfield
2017-01-31,2016,Liverpool,Chelsea,1-1,1,1,1,1,2,0,D,"Klopp, Jürgen",1,Anfield
2017-02-04,2016,Hull City,Liverpool,2-0,2,0,1,1,2,2,H,"Klopp, Jürgen",0,Away
2017-02-11,2016,Liverpool,Tottenham Hotspur,2-0,2,0,1,1,2,2,H,"Klopp, Jürgen",2,Anfield
2017-02-27,2016,Leicester City,Liverpool,3-1,3,1,1,1,4,2,H,"Klopp, Jürgen",1,Away
2017-03-04,2016,Liverpool,Arsenal,3-1,3,1,1,1,4,2,H,"Klopp, Jürgen",3,Anfield
2017-03-12,2016,Liverpool,Burnley,2-1,2,1,1,1,3,1,H,"Klopp, Jürgen",2,Anfield
2017-03-19,2016,Manchester City,Liverpool,1-1,1,1,1,1,2,0,D,"Klopp, Jürgen",1,Away
2017-04-01,2016,Liverpool,Everton,3-1,3,1,1,1,4,2,H,"Klopp, Jürgen",3,Anfield
2017-04-05,2016,Liverpool,AFC Bournemouth,2-2,2,2,1,1,4,0,D,"Klopp, Jürgen",2,Anfield
2017-04-08,2016,Stoke City,Liverpool,1-2,1,2,1,1,3,-1,A,"Klopp, Jürgen",2,Away
2017-04-16,2016,West Bromwich Albion,Liverpool,0-1,0,1,1,1,1,-1,A,"Klopp, Jürgen",1,Away
2017-04-23,2016,Liverpool,Crystal Palace,1-2,1,2,1,1,3,-1,A,"Klopp, Jürgen",1,Anfield
2017-05-01,2016,Watford,Liverpool,0-1,0,1,1,1,1,-1,A,"Klopp, Jürgen",1,Away
2017-05-07,2016,Liverpool,Southampton,0-0,0,0,1,1,0,0,D,"Klopp, Jürgen",0,Anfield
2017-05-14,2016,West Ham United,Liverpool,0-4,0,4,1,1,4,-4,A,"Klopp, Jürgen",4,Away
2017-05-21,2016,Liverpool,Middlesbrough,3-0,3,0,1,1,3,3,H,"Klopp, Jürgen",3,Anfield
